Zdjęcie satelitarne spoglądające na ziemię.	A satellite picture looking down at the earth.	Zdjęcie satelitarne Ziemii.
Dlatego chcą zaistnieć jako potęga przemysłowa w różnych branżach z dala od ropy naftowej.	So they want to emerge as an industrial powerhouse across the industries away from oil.	Chcą przejawiać się jako siła napędzająca przemysł w różnych branżach z daleka od ropy.
I umieściłem je na moim zdjęciu.	And I put them into my photograph.	Umieściłam je na swoim zdjęciu.
I znowu możesz myśleć o tym jak o prawie mapowaniu naszych autostrad międzystanowych, jeśli wolisz.	And again you can think of this as almost mapping our interstate highways if you will.	I znów można to traktować prawie jak mapowanie autostrad międzystanowych.
Więc co jest najlepsze.	So what is the best.	Która metoda jest najlepsza?
A w miejscach, gdzie są robaki, robaki jelitowe leczą dzieci z ich robaków.	And in places where there are worms intestinal worms cure the kids of their worms.	W miejscach występowania pasożytów głównie przewodu pokarmowego wystarczy wyleczyć dzieci.
Myślę, że te zasoby są niezwykle cenne.	I think these resources are incredibly valuable.	Uważam że są to niezwykle cenne informacje
A kiedy pobieramy próbkę i hybrydyzujemy ją z nią, otrzymujemy unikalny odcisk palca, jeśli będziesz ilościowo określić, jakie geny są włączone w tej próbce.	And when we take a sample and we hybridize it to it we get a unique fingerprint if you will quantitatively of what genes are turned on in that sample.	Kiedy zhybrydyzujemy próbkę otrzymamy unikalny odcisk palca dowód ilościowy potwierdzający które geny są włączone w danej próbce.
Widzimy ten wyjątkowy odcisk palca.	We can see this unique fingerprint.	Możemy zobaczyć ten unikalny odcisk palca.
Sfotografowałem go na miejscu zbrodni nad Snake River w Idaho.	I photographed him at the scene of the crime at the Snake River in Idaho.	Sfotografowałam go na miejscu zbrodni nad rzeką Wężową w Idaho.
OK, pomyśl, ile liter w tytule jego imienia.	OK think of how many letters in the title of his name.	OK pomyśl z ilu liter składa się jego imię.
Dalszą drogą dla nas jest teraz standaryzacja tej technologii.	The way forward for us is now to standardize this technology.	Kolejnym krokiem jest teraz standaryzacja tej technologii.
Oto jest pytanie.	That is the question.	Oto jest pytanie.
OK, po prostu stań przed sceną.	OK just stand stage forward.	OK stań tam przodem do sceny.
Widzisz, problem polega na tym, że jako ludzie ci trzej mogą się rozdzielić.	See the problem is that as humans these three can separate.	Problem polega na tym że u ludzi te trzy układy mogą być rozdzielne.
Czy możesz sobie wyobrazić potencjalne zastosowania potomne, wykrywanie zanieczyszczeń w glebie, aplikacje celne, wykrywanie nielegalnych towarów w kontenerach i tak dalej.	Can you imagine the potential offspring applications environmental detection of pollutants in soils customs applications detection of illicit goods in containers and so on.	Możecie sobie wyobrazić potencjalne pochodne zastosowania analizy środowiskowe wykrywanie zanieczyszczeń w glebie zastosowania przy odprawach celnych wykrywanie niedozwolonych dóbr w pojemnikach i tak dalej.
Więc to jest naprawdę znaczące.	So this is really considerable.	Jest to więc naprawdę znaczący wynik.
Czy możesz wstać.	Can you stand up.	Możesz wstać?
I to nie jest w jakimś abstrakcyjnym, metaforycznym sensie.	And this is not in some abstract metaphorical sense.	I to nie abstrakcyjnie czy metaforycznie.
Może kontemplować znaczenie nieskończoności i zadawać pytania o znaczenie własnego istnienia w naturze Boga.	It can contemplate the meaning of infinity ask questions about the meaning of its own existence about the nature of God.	nad znaczeniem nieskończoności zapytać o sens własnego istnienia i o naturę Boga.
Patrząc na proporcje i kombinacje różnych rodzajów pyłków w próbce, można bardzo dokładnie określić, skąd pochodzi.	By looking at the proportions and combinations of different kinds of pollen in a sample you can tell very precisely where it came from.	Patrząc na proporcje pyłków w badanej próbce Patrząc na proporcje pyłków w badanej próbce można precyzyjnie określić skąd ona pochodzi.
A więc takie są konsekwencje.	So those are the consequences.	To są więc konsekwencje.
DR Ma on idzie.	DR Ma he is walking.	DR Mamo on chodzi.
I to finansuje wiele moich badań.	And it funds a lot of my research.	Finansowanych jest z niego wiele moich badań.
A teraz chcesz, żebym oddał te pieniądze i wysłał je nieznajomemu.	And now you want me to give up this money and ship it to a stranger.	a potem chce żebyś oddał te pieniądze obcemu?
Co wydarzyło się w ciągu ostatnich 15 lat z tą pracą.	What has happened in the last 15 years with this work.	Co działo się z tymi badaniami na przestrzeni ostatnich 15 lat?
Będę grał na tych rockowych koncertach, stojąc na scenie zupełnie nieruchomo, a oni mówią: Co ona robi? Co ona robi.	I will play at these rock shows be on stage standing completely still and they are like What is she doing What is she doing.	Gram na koncertach rockowych stoję bez ruchu na scenie. Co ona robi?
Aby przekształcić to nieprzezroczyste 90000 godzin wideo w coś, co moglibyśmy zacząć widzieć, używamy analizy ruchu, aby wyciągnąć, gdy poruszamy się w przestrzeni i w czasie, co nazywamy robakami czasoprzestrzennymi.	In order to convert this opaque 90000 hours of video into something that we could start to see we use motion analysis to pull out as we move through space and through time what we call space time worms.	W celu przekonwertowania tych złożonych 90 tys. godzin nagrań video w coś co moglibyśmy zacząć rozumieć korzystamy z analizy ruchu w celu wydobycia w miarę jak poruszamy się w czasie i przestrzeni tzw. robaków czasoprzestrzennych .
Dlaczego na początku XXI wieku pokazałem, że kraje z wyższym odsetkiem ludzi godnych zaufania są bardziej zamożne.	Why I had shown in the early 2000s that countries with a higher proportion of trustworthy people are more prosperous.	Dlaczego? Wykazałem około roku 2000 że kraje z wyższym odsetkiem wiarygodnych ludzi lepiej prosperują.
Więc chociaż boję się wysokości, niedawno przypiąłem się do innego człowieka i wysiadłem z samolotu na wysokości 12000 stóp.	So even though I have a fear of heights I recently strapped myself to another human being and stepped out of an airplane at 12000 ft.	więc ostatnio mimo tego że mam lęk wysokości pozwoliłem przypiąć się do innego człowieka i wyskoczyłem z samolotu na wysokości 3650 metrów.
A potem pojechałem na spotkanie do Włoch.	And but then I went to a meeting in Italy.	I później udałem się na konferencję do Włoch.
Ponieważ tak właśnie się robi z pękniętą szybą.	Because that is what you do with a cracked pane.	Bo tak się właśnie robi z pękniętą szybą.
Margines błędu jest wąski Tutaj podaję oczekiwaną długość życia w chwili urodzenia od 30 lat w niektórych krajach do około 70 lat.	The error margin is narrow Here I put life expectancy at birth from 30 years in some countries up to about 70 years.	Margines błędu jest mały. Tu wpisałem oczekiwaną średnią długość życia przy urodzeniu od 30 lat w niektórych krajach aż do około 70 lat.
Jednym z pytań, z którego wiele się nauczyłem, było to: Który kraj ma najwyższą śmiertelność dzieci spośród tych pięciu par.	And one of the questions from which I learned a lot was this one Which country has the highest child mortality of these five pairs.	Jedno z pytań z których się wiele dowiedziałem było następujące W którym kraju z tych pięciu par jest najwyższa śmiertelność wśród dzieci?
Okablowane zwykle przewodem 14 AWG.	Wired with 14 gauge wire typically.	Zwykle jest wyposażony w kabel kalibru 14.
Ale po prostu zapytaj, jaka cząsteczka ma się złożyć.	But just ask what the molecule how should it fold up.	Ale pojawiło się pytanie jak ta molekuła jest zwinięta?
Jeśli coś nie jest idealne, jeśli nie pasuje do tego z premedytacją modelu śmietnika.	If something isn not perfect if it doesn not line up with that premeditated model dumpster.	Jeśli coś nie jest doskonałe jeśli nie pasuje do zaplanowanego modelu do kosza.
Ups, to ups, to Landfill Landfill Landfill.	Oops this oops that Landfill Landfill Landfill.	Ups to ups tamto. Śmietnik. Śmietnik. Śmietnik.
Teraz cały ten apolliński model platoński jest tym, na czym opiera się przemysł budowlany, a jest wiele rzeczy, które to pogarszają.	Now all that that Apollonian Platonic model is what the building industry is predicated on and there are a number of things that exacerbate that.	Więc cały ten apolliński platoński model to na nim się opiera przemysł budowlany i kilka rzeczy to jeszcze pogarsza.
Co o tym myślisz kochanie.	What do you think honey.	Co o tym myślisz kochanie?
Biolog Lewis Wolpert uważa, że ​​dziwaczność współczesnej fizyki to tylko skrajny przykład Nauka w przeciwieństwie do technologii narusza zdrowy rozsądek.	The biologist Lewis Wolpert believes that the queerness of modern physics is just an extreme example Science as opposed to technology does violence to common sense.	Biolog Lewis Wolpert jest przekonany że dziwność współczesnej fizyki to tylko skrajny przykład. Nauka w przeciwieństwie do technologii krzywdzi zdrowy rozsądek.
Jednak jako muzyk muszę robić wszystko, czego nie ma w muzyce.	However what I have to do as a musician is do everything that is not on the music.	Jako muzyk zajmuję się jednak tym czego w nutach nie ma.
Ale myślę, że chodzi o to, że te osoby mają te osobowości i charaktery.	But that is I think what this is all about is that these individuals have these personalities and characters.	Myślę że właśnie o to w tym wszystkim chodzi te wszystkie zwierzęta mają swoje osobowości i charaktery.
Muszę zagrać kawałek muzyki. No cóż, to pomoże ci kontrolować.	I need to play a piece of music Oh well this will help your control.	Oni To pomaga wyćwiczyć kontrolę .
Teraz jestem skazany na spędzenie dużo czasu z wyjątkowymi, bardzo wyjątkowymi indywidualistycznymi i często uwodzicielskimi postaciami kobiecymi.	Now I am destined to spend a lot of time with some unique very very special individualistic and often seductive female characters.	Coż jestem skazany na spędzanie mnóstwa czasu z wyjątkowymi bardzo bardzo szczególnymi indywidualistycznymi i często uwodzicielskimi istotami płci żeńskiej.
Pamiętam mojego nauczyciela Kiedy zacząłem swoją pierwszą lekcję, byłem przygotowany z patykami gotowymi do wyjścia.	I remember my teacher When I first started my very first lesson I was all prepared with sticks ready to go.	Pamiętam że na pierwszą lekcję przyszłam z pałkami gotowa grać.
Urządzenie radiowe kontroluje każdy mój krok, a czujnik podnosi moją stopę za każdym razem, gdy idę.	A radio device is controlling every step I take and a sensor picks up my foot for me every time I walk.	Urządzenie radiowe kontroluje każdy krok który robię. I czujnik podrywa moją stopę do góry za mnie za każdym razie kiedy idę.
Zrobię dokładnie to, co mi powiedziano.	I will do exactly as I am told.	Zastosuję się do nich co do joty.
Więc niebiosa Co miałem zrobić, nie potrzebowałem już patyków, nie pozwolono mi ich mieć.	So heavens What was I to do I no longer required the sticks I wasn not allowed to have these sticks.	Nie wiedziałam co robić. Kazał nie używać pałek. Nie wiedziałam co robić. Kazał nie używać pałek.
DJ To było niesamowite, bo widać, że ten lew robi dokładnie to, co ma na imię. Skupia się na tej hienie i zamierza to dostać.	DJ It was amazing because you can see that this lion is doing exactly what his name He is focused on this hyena and he is going to get it.	Dereck To niezwykłe ale możecie się przekonać że ten lew robi dokładnie to Skupił się na tej hienie i dopadnie ją.
I zmieni świat, jaki znamy.	And it is going to change the world as we know it.	Zmieni to świat który znamy.
A co z tymi wszystkimi dzieciakami jak ja, które były w szkole, tak jak niektórzy z was, którzy byli w szkole i nie mieli szansy i nigdy nie będą mieli szansy uczestniczyć w nauce i technologii.	What about all the kids like me that were in school kids like some of you out there that were in school and didn not get a chance and will never get a chance to participate in science and technology.	Co z dziećmi jak ja takimi jak niektórzy z was które chodziły do szkoły ale nie miały okazji zaznajomić się z nauka i technologią?
Jeśli korzystasz z Twittera lub innych sieci społecznościowych i nie zdawałeś sobie sprawy, że jest to przestrzeń z wieloma Brazylijczykami, jesteś jak większość z nas.	Now if you are using Twitter or other social networks and you didn not realize this was a space with a lot of Brazilians in it you are like most of us.	Jeśli używacie Twittera lub innych portali i nie zdajecie sobie sprawy że jest tam sporo Brazylijczyków to witam w klubie.
Tak więc Brazylijczycy udali się na ten pierwszy mecz z Koreą Północną, rozwiesząc ten baner, rozpoczęli kampanię na Twitterze i próbowali przekonać resztę z nas do tweetowania frazy Cala a boca Galvao.	So Brazilians went to that first match against North Korea put up this banner started a Twitter campaign and tried to convince the rest of us to tweet the phrase Cala a boca Galvao.	Brazylijczycy poszli na pierwszy mecz z Koreą Północną wzięli ten baner zaczęli kampanię na Twitterze i spróbowali przekonać innych żeby wrzucić wyrażenie Cala a boca Galvao .
Ale tym, który naprawdę mnie stresuje, że nie byłem w stanie zrozumieć, jest to wyrażenie Cala a boca Galvao.	But the one that is really been sort of stressing me out that I haven not been able to figure out is this phrase Cala a boca Galvao.	Ale wyrażeniem które mnie denerwowało którego nie mogłem rozgryźć Cala a boca Galvao .
Niektóre z nich najważniejsze są mentalne.	Some of them the most important are mental.	A jeszcze inne najważniejsze umysłowe.
Na koniec pokażę przykładową historię kota Dusty'ego.	And last I am going to show you the example the story of Dusty the cat.	Na koniec pokażę wam przykład historię kota Dusty ego.
Mózg to mózg, który w ogóle nie potrzebuje oprogramowania 3D, ponieważ żyje na powierzchni stawu na równinie Edwina Abbotta.	A water strider is brain doesn not need 3D software at all since it lives on the surface of the pond in an Edwin Abbott flatland.	Mózg nartnika wodnego w ogóle nie potrzebuje pojęcia 3D ponieważ żyje na powierzchni wody we flatlandii Edwina Abbotta.
Twoim zadaniem jest wydobywać takie rzeczy na pierwszym planie i wprowadzać je na karty historii.	Your job is to excavate things like this in the foreground and make them enter the pages of history.	Wydobywamy to co widać w tle żeby odnotować to w historii dziejów.
Następnie przenosi nas do współczesności mój kolega współpracownik i ekspert w dziedzinie kymatyki, John Stewart Reed.	Then bringing us into the present day is a fellow collaborator of mine and cymatics expert John Stewart Reed.	Wracając zaś do teraźniejszości przykładem jest mój współpracownik i ekspert w dziedzinie kymatyki John Stewart Reed.
Więc masz te trzy tajemnice.	So you have these three mysteries.	Mamy te trzy zagadki.
I tak ten materiał wyjściowy wraca do podstawowego budulca.	And so this starting material is back to the basic building block.	I tak ten materiał początkowy na nowo staje się podstawowym elementem budulcowym.
Odkryłem, że generał Tso to krewni, którzy wciąż są w małym miasteczku.	And I actually found a whole bunch of General Tso is relatives who are still in the little town.	I odnalazłam wielu krewnych generała którzy wciąż tu mieszkają.
Ale możemy popchnąć ten pomysł dalej.	But we can push this idea further.	Możemy pójść dalej.
Cóż, byłem dorosłym mężczyzną, który miał wszystkie te rytuały i stało się tak, że poczułem pulsowanie, aw mojej głowie był okrutny strach.	Well I was a grown man who had all of these rituals and it got so there was a throbbing there was a ferocious fear in my head.	Byłem dorosłym człowiekiem a rządziły mną wszystkie te nawyki i doszło do tego że miałem w głowie poczucie pulsującego dzikiego lęku.
Dam ci przykład.	I will give you an example.	Dam wam przykład.
Pokazałem im wszystkie zdjęcia generała Tso Chicken, które ci pokazałem i są tak, jakbyśmy nie znali tego dania.	Showed them all the pictures of General Tso Chicken that I showed you and they are like we don not know this dish.	Pokazałam im te same zdjęcia kurczaka generała Tso co wam. Nikt z nich nie znał tej potrawy.
Co to jest.	What is this.	Co to?
Chcemy wiedzieć, jak przechodzisz od wody i białka do płynnego Kevlaru do tego naturalnego Kevlaru.	We want to know how you go from water and protein to this liquid Kevlar to this natural Kevlar.	Chcemy wiedzieć jak z wody i białka dojść do tego płynnego kevlaru naturalnego kevlaru.
Więc nie jestem wolny od tego wszystkiego. Ale działa. Zawsze działa.	So I am not free of all of this But it is worked It is always worked.	Nie byłem w stanie uwolnić się od niej zupełnie. Ale to zadziałało. To zawsze działało.
Mój ojciec życzliwie obserwował demonstracje w miesiącu maju, ale jego serce było gdzie indziej, podobnie jak jego czas, ponieważ miał ponad 15 krajów do służby.	My father watched benevolently of course the demonstrations of the month of May but his heart was elsewhere and so was his time because he had over 15 countries to serve.	Mój ojciec obserwował oczywiście życzliwie demostracje w maju ale jego serce było gdzie indziej miał 15 krajów do obsłużenia.
Wszystkie ruchy zatrzymały się na fałszowaniu.	All the movements stopped at falsifying.	Wszystkie ruchy zatrzymywały się przy falsyfikowaniu.
Nie możemy już się rozszerzać, ponieważ powoduje to erozję granic planetarnych.	We cannot expand anymore because it erodes the planetary boundaries.	Nie możemy się bardziej rozszerzać bo to nadszarpuje granice planetarne.
Zaczął prasę Zaczął grawerować.	He started a press He started photoengraving.	Uruchomił prasę. Zajął się fotograwiurą.
Zrobiłem kampanię reklamową dla firmy Schweppes, czyli Coca Cola i była to bardzo ciekawa pod względem prawnym.	I did an advertising campaign for Schweppes which is Coca Cola and so that was very interesting in terms of the legalities.	Zrobiłam kampanię reklamową Schweppes a dla Coca Coli i to było bardzo ciekawe jeśli chodzi o zgodność z prawem.
Były to oczywiście ofiary finansowe, ponieważ zawsze odmawiał zapłaty.	There were obviously financial sacrifices because he always refused to be paid.	Były oczywiście finansowe ofiary ponieważ zawsze odmawiał zapłaty.
To jest wtedy odpowiednik Wielkiego Wybuchu dla ludzkiego rozwoju w bezpiecznej przestrzeni operacyjnej granic planetarnych.	Now this is the Big Bang equivalent then of human development within the safe operating space of the planetary boundaries.	To jest odpowiednik Wielkiego Wybuchu w rozwoju ludzkości wewnątrz bezpiecznej przestrzeni planetarnych granic.
Ale nawet w twardym obszarze polityki mamy innowacje.	But even on the hard policy area we have innovations.	Innowacje pojawiają się również w cięższych obszarach polityki.
Mój ojciec robił fałszywe dokumenty dla amerykańskich dezerterów, którzy nie chcieli brać broni przeciwko Wietnamczykom.	My father made false papers for the American deserters who did not wish to take up arms against the Vietnamese.	Mój ojciec wyrabiał fałszywe papiery dla amerykańskich dezerterów którzy nie chcieli walczyć przeciw Wietnamczykom.
W każdym razie nikt by ich nie śledził, z wyjątkiem garstki mężczyzn i kobiet z przekonaniem i odwagą.	Anyhow nobody would have followed them except for a handful of men and women of conviction and courage.	Tak czy owak nikt by za nimi nie podążał poza garstką mężczyzn i kobiet z przekonaniem i odwagą.
I wszystko, co mogłem wykryć, to ta energia.	And all I could detect was this energy energy.	Docierała do mnie jedynie energia.
Ta seria wystaw została stworzona specjalnie po to, aby spróbować zakwestionować ideę tego, co oznaczałoby teraz, w tym momencie historii, postrzeganie sztuki jako katalizatora, co to znaczy teraz, w tym momencie historii, kiedy definiujemy i redefiniujemy kulturę czarnej kultury, szczególnie w moim przypadek, ale ogólnie kultura.	This series of exhibitions was made specifically to try and question the idea of what it would mean now at this point in history to see art as a catalyst what it means now at this point in history as we define and redefine culture black culture specifically in my case but culture generally.	Ta seria wystaw została stworzona specjalnie po to by zadać pytanie co znaczy dziś w tym momencie historii widzieć sztukę jako katalizator co znaczy dziś w tym momencie historii kiedy definiujemy i redefiniujemy kulturę kulturę afroamerykańską w moim przypadku ale też kulturę ogólnie.
W tym momencie stałem się trochę bardziej ambitny i postanowiłem zobaczyć, co jeszcze mogą zrobić dzieci z komputerem.	At that point I became a little more ambitious and decided to see what else could children do with a computer.	Od tej pory stałem się ambitniejszy i postanowiłem zobaczyć co jeszcze potrafią zrobić dzieci z komputerem.
Nie możesz słusznie, to nie ich odpowiedzialność, to moja odpowiedzialność, ja muszę zająć się własnymi problemami.	You can not rightly it is not their responsibility it is my responsibility I have to take care of my own problems.	To się nie uda. To nie ich odpowiedzialność. To moja odpowiedzialność. Sam muszę sobie poradzić z własnymi problemami.
To było wrażliwe, że musieliśmy iść w górę hierarchii dowodzenia, przekonać ich, że to jest słuszne, i zrobić to wszystko na nośniku elektronicznym.	It was sensitive we had to go up the chain of command convince them that this was the right thing to do and do all of this on electronic medium.	To była delikatna materia musieliśmy dotrzeć do najwyższego dowództwa przekonać ich że to jest dokładnie to co trzeba zrobić i przeprowadzić to wszystko przy pomocy mediów elektronicznych.
Sposobem na zadanie tego pytania jest przyjrzenie się neandertalczykowi pochodzącemu z południowej Europy i porównanie go z genomami ludzi, którzy żyją dzisiaj.	And the way to ask that question is to look at the Neanderthal that comes from Southern Europe and compare it to genomes of people who live today.	I sposobem zadania tego pytania jest przyjrzenie się neandertalczykom z Europy Południowej i porównanie ich do genomów współczesnych ludzi.
Zdecydowaliśmy, że musimy postawić nasze pieniądze tam, gdzie są nasze usta.	We decided that we needed to put our money where our mouth is.	Postanowiliśmy że musimy poprzeć słowa czynami.
Bum.	Boom.	Bum!
Aby zacząć odpowiadać na takie pytania, moja grupa badawcza od ponad 25 lat pracuje nad metodami ekstrakcji DNA ze szczątków neandertalczyków i wymarłych zwierząt, które mają dziesiątki tysięcy lat.	And to begin to answer such questions my research group since over 25 years now works on methods to extract DNA from remains of Neanderthals and extinct animals that are tens of thousands of years old.	I by zacząć odpowiadać na takie pytania moja grupa badawcza od przeszło 25 lat pracuje nad metodami ekstrakcji DNA z pozostałości neandertalczyków i wymarłych zwierząt które mają dziesiątki tysięcy lat.
Poszliśmy dalej, nawiązaliśmy współpracę z University of Technology Jamaica, gdzie mam teraz spotkanie.	We have gone further we have formed a relationship with the University of Technology Jamaica where I now have an appointment.	Poszliśmy dalej nawiązaliśmy kontakt z Uniwersytetem Technologicznym na Jamajce. gdzie obecnie wykładam.
Wiesz, że to będzie zmienne.	You know it is going to be variable.	Rozumiecie są różne przypadki.
Więc powiedziałem: Tak, zostawię to tutaj na dwa miesiące.	So I said Yeah I will leave it here for two months.	Ja na to Cóż zostawiam go tu na 2 miesiące.
Innymi słowy, użyj tej fiksacji, aby zmotywować tego dzieciaka, co jest jedną z rzeczy, które musimy zrobić.	In other words use that fixation in order to motivate that kid that is one of the things we need to do.	Innymi słowy należy wykorzystać obsesję żeby zmotywować dziecko tym musimy się zająć.
I powiedziała: Cóż, to jest ładne, ale znasz nasz kolor naprawdę jest zielony I nauczyłem się wtedy, że słuchanie to nie tylko kwestia cierpliwości, ale że kiedy żyjesz z miłości i jesteś zależny przez całe życie, naprawdę trudno jest powiedzieć, co masz na myśli .	And she said Well it is pretty but you know our color really it is green And I learned then that listening isn not just about patience but that when you have lived on charity and dependent your whole life long it is really hard to say what you mean.	A ona powiedziała Cóż jest ładnie ale wiesz ten kolor tak naprawdę jest zielony. I I dowiedziałam się że słuchanie nie polega jedynie na cierpliwości ale jeśli utrzymujesz się z pracy charytatywnej i od tego uzależniasz całe swoje życie naprawdę ciężko jest powiedzieć co naprawdę myślisz.
A potem to jest ona tam.	And then that is her over there.	Widzicie ją teraz.
Chcieli integracji zespołu, czyli maszyny działającej na członków zespołu, a nie odwrotnie.	They wanted band integration that is the machine acting upon the band members specifically not the other way around.	Zespół miał byś zinetgrowany maszyna miała działać w oparciu o członków zespołu a przede wszystkim nie na odwrót.
Wyzwał mnie, bym wymyślił pokój z iluzjami optycznymi.	And he got me challenged to figure out an optical illusion room.	Rzucił mi wyzwanie miałam opracować salę złudzeń optycznych. Rzucił mi wyzwanie miałam opracować salę złudzeń optycznych.
Dwa miesiące później i jest to teraz udokumentowane w czasopiśmie Information Technology for International Development, że akcenty się zmieniły i były niezwykle zbliżone do neutralnego brytyjskiego akcentu, w którym nauczyłem się przemawiać na syntezatorze tekstu.	Two months later and this is now documented in the Information Technology for International Development journal that accents had changed and were remarkably close to the neutral British accent in which I had trained the speech to text synthesizer.	Dwa miesiące później napisaliśmy na ten temat artykuł w czasopiśmie Informatyka w kształceniu  ich akcent się zmienił i był znacznie bliższy neutralnemu brytyjskiemu akcentowi na którym trenowałem program.
Powiedziałem Nie używaj metody babci.	I said No use the method of the grandmother.	Odparłem Nie użyj metody babci.
Myślę, że naszym wrogiem była fizyka, a ona jest okrutną kochanką.	I think our enemy was physics and she is a cruel mistress.	Myślę że naszym wrogiem była fizyka a jest ona okrutną kochanką.
Więc to się nazywa Victoria Crater, który ma rozmiar kilku boisk piłkarskich.	So this is called Victoria Crater which is about a few football fields in size.	Krater Victoria ma powierzchnię kilku boisk futbolowych. Krater Victoria ma powierzchnię kilku boisk futbolowych.
Gospodarz Dziękuję Dziękuję.	Host Thank you Thank you.	Prowadząca Dziękuję. Dziękuję.
A ten Rover będzie bardziej podobny do chemika.	And that Rover will be more kind of like a chemist.	Ten łazik będzie chemikiem.
W rzeczywistości dzielimy tę samą genealogię z lodem Ozziem.	We actually share the same genealogy with Ozzie the iceman.	Właściwie to mamy to samo pochodzenie co człowiek lodu Ozzie.
Pozwólcie, że przejdę do następnego krótkiego filmu.	So let me go on the next short video.	Oto filmik.
PM Jeśli możesz to przekazać, kiedy skończysz. Tak myślę, że straciłem trochę orientacji. Spojrzałem w górę, w to światło.	PM If you can pass it down when you are done Yeah I think I lost a little orientation I looked up into this light.	Jakbyś mógł to przekaż nam kiedy skończysz. Myślę Straciłem orientację przez patrzenie w światło ale.
Musimy więc zbadać różne rodzaje materiałów, aby uzyskać kształt, który chcemy uzyskać.	So we have to study all kinds of different materials the shape that we want to do.	Badamy różne materiały różne konstrukcje.
Pomyśl więc o tym jak o cienkim jak papier, ogromnym obszarze wielu setek tysięcy mil, który się obraca.	So think about it as a paper thin huge area of many hundreds of thousands of miles which is rotating.	Wyobraźcie sobie że to cieniutki wirujący obszar szeroki na dziesiątki tysięcy kilometrów.
To jeden bardzo duży krater. Geolodzy uwielbiają kratery, ponieważ kratery są jak kopanie dużej dziury w ziemi bez konieczności wykonywania w niej prawdziwej pracy i można zobaczyć, co znajduje się pod powierzchnią.	This is one very large crater Geologists love craters because craters are like digging a big hole in the ground without really working at it and you can see what is below the surface.	Geolodzy uwielbiają takie kratery bo to jakby gotowy odwiert bo to jakby gotowy odwiert pokazujący przekrój gleby.
Spróbuj najpierw zbudować porozumienie polityczne.	Try and build a political settlement first.	Najpierw jest próba zbudowania ośrodka politycznego.
Okazało się, że nasz kamerzysta był dość nerwowym pilotem w najlepszym wypadku, zanim wsiedliśmy do samolotu, zapytał pilota, ile czasu zajmie ten lot, a pilot rosyjski kompletnie z powagą odpowiedział: Sześć godzin, jeśli będziemy żyć.	Our cameraman who it turned out was a pretty nervous flyer at the best of times actually asked the pilot before we got on the plane how long this flight would take and the pilot Russian pilot completely deadpan replied Six hours if we live.	Nasz kamerzysta który bał się latać zapytał pilota zanim weszliśmy na pokład jak długo będziemy lecieć a pilot rosyjski pilot całkowitą powagą odpowiedział Sześć godzin jeżeli przeżyjemy .
Z jednej strony deklaruje ideę odbudowy efektywnego państwa na wzór Skandynawii lat pięćdziesiątych.	On the one hand it pays lip service to the idea of rebuild an effective state in the image of Scandinavia in the 1950s.	Z jednej strony opłaca się udzielać nieszczerego poparcia idei odbudowy efektywnego państwa na wzór Skandynawii w latach 1950.
I dlaczego jest to takie trudne na początku.	And why is it so difficult initially.	Dlaczego na początku jest taka trudna?
Chcę mówić doskonale po angielsku.	T I want to speak perfect English.	N Chcę mówić po angielsku idealnie!
Stopniowo zmieniał się od polityki grabieży do polityki nadziei Dziękuję.	Gradually it would shift from a politics of plunder to a politics of hope Thank you.	Stopniowo nastąpiłoby przejście od polityki rabunkowej do polityki nadziei. Dziękuję.
Przeczytam jeszcze jedną, ale zwykle tego nie mówię.	I will read just one more I don not usually say that.	Przeczytam jeszcze tyko jeden. Zwykle tego nie mówię.
Niedźwiedzie polarne na Oceanie Arktycznym poruszają się po martwych liniach prostych.	Polar bears on the Artic Ocean move in dead straight lines.	Niedźwiedzie polarne na Oceanie Arktycznym przemieszczają się w idealnej linii prostej.
Jeśli nie dostaniesz reformy polityki i pomocy, nie otrzymasz naprawy gospodarczej, która jest prawdziwą strategią wyjścia dla sił pokojowych.	If you don not get the policy reform and the aid you don not get the economic recovery which is the true exit strategy for the peacekeepers.	Jeśli nie stworzy się polityki reform i pomocy nie ma odnowy gospodarczej która jest prawdziwą strategią wyjścia dla sił pokojowych.
Chiny nadal mają duże obszary zacofania, a dochód na mieszkańca jest lepszą miarą stopnia zaawansowania gospodarki.	China still has large areas of underdevelopment and per capita income is a better measure of the sophistication of the economy.	w Chinach nadal są olbrzymie obszary zacofania. A wskaźnik per capita zawsze lepiej oddaje stopień wyrafinowania ekonomicznego.
Więc angielska mania jest punktem zwrotnym.	So English mania is a turning point.	Obsesja języka angielskiego jest punktem zwrotnym.
Moim zdaniem byłem rycerzem, który próbował pomóc nauce iść naprzód.	In my mind I was actually a knight trying to help science move along.	Widziałem siebie jako rycerza który popycha naukę do przodu.
Patrząc na przykład na sześciokąt, przypomina on amebę, która nieustannie zmienia swój własny profil.	If you look at the hexagon for instance it is like an amoeba which is constantly changing its own profile.	Weźmy na przykład sześciokąt. Ciągle zmienia kształt jak ameba.
Rodzice patrzyli w okno.	The parents were looking in the window.	Rodzice zaglądali przez okno.
Cóż, robimy mnóstwo pomp.	Well we make lots and lots of pumps.	Robimy wiele pompek.
To jest ołówek z kilkoma szczelinami.	Now this is a pencil with a few slots over here.	To ołówek z paroma rowkami.
Potrzebujesz tylko tony.	You just need a ton.	Potrzebne są tylko składniki.
Dorastając, usłyszałem tak wiele wiedzy, tak wiele wglądów i tak wiele mądrości wokół tego stołu, że zacząłem nazywać go stołem mądrości.	And as I grew up I heard so much knowledge and so many insights and so much wisdom come out around this table I began to call it the wisdom table.	I kiedy dorastałam słyszałam tyle wiedzy wnikliwych uwag tyle mądrości wychodziło za tego stołu że zaczęłam go nazywać stołem mądrości.
Nazywa się to rurką zaworu cyklicznego.	This is called a cycle valve tube.	To rurka od wentyla.
Pod koniec 1911 r. Na początku 1912 r. Odbył się wyścig, który jako pierwszy dotrze na biegun południowy do serca kontynentu antarktycznego.	Late 1911 early 1912 there was a race to be the first to the South Pole the heart of the Antarctic continent.	Na przełomie 1911 i 1912 Toczyła się walka kto będzie pierwszy na Biegunie Południowym w sercu Antarktydy.
A statek tonie, a kapitan stracił wszystko oprócz kamizelki ratunkowej.	And the ship sinks and the captain has lost everything but for a life jacket.	I statek zatonął kapitan stracił wszystko prócz swej kamizelki ratunkowej.
Zapytaliśmy o to ćpuna, a oni są jak Czy jesteś szalony.	We asked that to a junkie and they are like Are you nuts.	Zapytaliśmy ćpuna a on na to Oszalałaś?
To jest idea obliczeń.	It is the idea of computation.	To idea obliczalności.
A żeby to zrobić, wymaga to ekstremalnych temperatur, ekstremalnych ciśnień i dużych ilości zanieczyszczeń.	And to make that it involves extremes of temperature extremes of pressure and loads of pollution.	Ale żeby je wykonać potrzebujemy ogromnej temperatury potężnego ciśnienia i emisji dużej ilości zanieczyszczeń.
Mam tu wyzwalacz, tutaj wyzwalacz, tutaj, właśnie tam.	I have a trigger here trigger here here here Right there.	Mamy jeden pad tutaj jeden tutaj tu tu i tam.
Więc zasadniczo jesteś w stanie osiągnąć dość wysoki wskaźnik używania prezerwatyw w seksie komercyjnym.	So essentially you are able to achieve quite high rates of condom use in commercial sex.	Zasadniczo można więc osiągnąć wysoki poziom użycia prezerwatyw w komercyjnym seksie.
Przy odrobinie planowania moglibyśmy przekształcić przestrzeń zdominowaną przez ruch uliczny w taką, która zapewnia otwartą przestrzeń dla ludzi, ponownie łączy ludzi z jedzeniem i przekształca odpady w zamknięte możliwości.	And with just a little bit of planning we could transform a space dominated by traffic into one that provides open space for people reconnects people with food and transforms waste into closed loop opportunities.	Wystarczyło troszkę planowania i mogliśmy przekształcić miejsce zdominowane przez korki w inne dostarczające ludziom otwartą przestrzeń łączące ludzi poprzez jedzenie i przetwarzające problem odpadów w model zamkniętej pętli.
I kolego, który nas wkurzył.	And buddy that made us mad.	O stary to nas rozeźliło.
Powiedzmy, że mamy laboratorium, które to odkrywa.	So let is say we have a lab finding that.	Powiedzmy że w laboratorium zbadano
Jak dotąd w Wolfram Alpha jest około 8 milionów wierszy kodu Mathematica zbudowanych przez ekspertów z wielu różnych dziedzin.	So far there are about 8 million lines of Mathematica code in Wolfram Alpha built by experts from many many different fields.	Na chwilę obecną mamy 8 milionów linii kodu w języku Mathematica w naszej wyszukiwarce Wolfram Alpha napisanych przez ekspertów w wielu dziedzin.
Istnieje niewyczerpana liczba programów.	There is an inexhaustible supply of programs out there.	Jest tu nieskończona liczba programów.
Jeśli zmienimy rozmiary krajów świata proporcjonalnie do przedmiotu zainteresowania, zobaczymy, że Afryka Subsaharyjska jest regionem najbardziej dotkniętym przez HIV / AIDS.	If we resize the countries of the globe in proportion to the subject of interest we see that Sub Saharan Africa is the worst hit region by HIV/AIDS.	Jeśli odwzorujemy powierzchnię państw proporcjonalnie do interesującej nas zmiennej to Czarna Afryka jest najsilniej dotknięta HIV/AIDS.
Master / Slave w MOMA seria projektów utwór zatytułowany Parasite.	Master/Slave at the MOMA the project series a piece called Parasite.	Seria projektów Pan/Niewolnik w MOMA praca zatytułowana Pasożyt .
A potem miasto Amsterdam dało nam plac i poprosiło nas, żebyśmy coś zrobili.	And then the city of Amsterdam gave us a plaza and asked us to do something.	Oto projekt w Amsterdamie gdzie poproszono nas o zrobienie czegoś na placu.
Jeśli spojrzysz na Triceratopsa, zobaczysz, że się zmienia, zmienia kształt.	If you look at the Triceratops you can see it is changing it is shape shifting.	Jeśli przyjrzysz się triceratopsowi to widać jak się zmienia zmienia swój kształt.
Równoległe wszechświaty.	Parallel universes.	Wszechświaty równoległe.
Pierwszą nauką kosmologiczną, która przypominała naukę, była nauka arystotelesowska i była hierarchiczna.	The first science of cosmology that was anything like science was Aristotelian science and that was hierarchical.	Pierwsze teorie kosmologiczne które można by uznać za naukę były nauką arystotelejską uporządkowaną hierarchicznie.
Jestem szczęśliwy, że żyję, jestem szczęśliwy, że żyję.	I am happy I am alive I am happy I am alive.	Cieszę się że żyję. Cieszę się że żyję.
I ten budynek, który jest po prostu naturalnie hermetyczny, rozebraliśmy.	And this building which is just naturally hermetic we stripped.	I tak ten budynek który naturalnie jest hermetyczny został przez nas obnażony.
Mamy więc nowe, błyszczące, średnie i bardzo stare, ciemne.	So we got brand new ones shiny ones medium ones and very old dark ones.	Dostaliśmy nowe błyszczące monety średnie oraz bardzo stare bardzo ciemne.
To jest policja, która się tego wszystkiego pozbywa.	That is the police getting rid of it all.	To policja pozbywa się wszystkiego.
Oczekuje się, że będziesz pisać pouczające, przejmujące i charakterystyczne historie, a eksperymentalną i awangardę pozostawić swoim zachodnim kolegom.	You are expected to write informative poignant and characteristic stories and leave the experimental and avant garde to your Western colleagues.	Oczekuje się od nas pisania pouczających wzruszających i charakterystychnych historii i pozostawienia eksperymentów i awangardy swoim koleżankom z Zachodu.
Raz w tygodniu spotyka się ze swoim mężem i mówi, że bardzo chciałabym, żebyś mi podziękowała za wszystkie rzeczy, które zrobiłem w domu i z dziećmi.	She once a week meets with her husband and says I would really like you to thank me for all these things I did in the house and with the kids.	Raz w tygodniu mówi do męża Chciałabym abyś podziękował mi za wszystko co robię dla domu i dzieci .
Nawiasem mówiąc, ten odsetek jest mniej więcej taki sam w Stanach Zjednoczonych, Niemczech i Francji.	That percentage by the way is about the same in the US and Germany and France.	Procentowo to tyle samo co w USA Niemczech i Francji.
Jednym z nich jest wzrost w kierunku społeczności i dzielnic oraz zwiększony nacisk na sąsiadów jako system wsparcia.	One is the rise toward communities and neighborhoods and increased emphasis on your neighbors as your support system.	Jednym z nich jest otwarcie się na społeczność lokalną i sąsiedztwo i zwiększenie akcentu sąsiadów jako systemu wsparcia.
Teraz, na początku lat 70. w Ankarze, było to trochę niezwykłe.	Now in the early 1970s in Ankara that was a bit unusual.	Na początku lat 70 tych w Ankarze było to nieco niezwykłe.
Nasze doświadczenie wskazuje na niesamowity wzrost produktywności człowieka o ponad 20 procent dzięki zastosowaniu tych roślin.	Our experience points to an amazing increase in human productivity by over 20 percent by using these plants.	Nasze doświadczenia pokazują niesamowity wzrost ludzkiej produktywności o ponad 20% dzięki użyciu tych roślin.
Ale zamiast się ustatkować, pojechałem do Arizony.	But instead of settling down I went to Arizona.	Zamiast osiedlania się jednak wylądowałam w Arizonie.
W tym sensie lubię myśleć o mojej fikcji jako o lokalnej i uniwersalnej zarówno stąd, jak i wszędzie.	In that sense I like to think of my fiction as both local and universal both from here and everywhere.	W pewnym sensie lubię myśleć że moja fikcja jest jednocześnie lokalna i uniwersalna jest zarazem stąd i zewsząd.
Bogactwo 13 bilionów dolarów wyparowało w ciągu ostatnich dwóch lat.	Thirteen trillion dollars in wealth has evaporated over the course of the last two years.	13 bilionów dolarów bogactwa wyparowało w ciągu minionych dwóch lat.
I może ktoś nigdy ci tego nie powiedział, ale wykonałeś naprawdę dobrą robotę.	And maybe somebody is never said that to you but you have done a really really good job.	Możliwe że nikt tego wam nie powiedział ale wykonaliście kawał dobrej roboty.
Uruchomiony w komórce program mógłby wykonać i może skutkować tą osobą lub z niewielką zmianą może skutkować tą osobą lub inną małą zmianą tej osoby lub większą zmianą tego psa, tego drzewa lub tego wieloryba.	Booted up in a cell the program would execute and it could result in this person or with a small change it could result in this person or another small change this person or with a larger change this dog or this tree or this whale.	Jeśli uruchomilibyśmy go w komórce rezultatem mogłaby być ta osoba a po niewielkich zmianach ta po innej zmianie ta a po większej zmianie ten pies drzewo czy wieloryb.
Więc teraz możesz dobrze powiedzieć, dlaczego origami DNA nie jest końcem historii.	So now you can say all right why isn not DNA origami the end of the story.	Ale dlaczego origami DNA nam nie wystarczy? Ale dlaczego origami DNA nam nie wystarczy?
Wie, kiedy przestać rosnąć, ponieważ może liczyć.	It knows when to stop growing because it can count.	Program wie gdzie się zatrzymać bo potrafi odliczać.
A w przypadku programowania molekularnego pytanie brzmi: skąd Twój telefon komórkowy wie, kiedy przestać rosnąć.	And for molecular programming the question is how does your cell phone know when to stop growing.	Programista molekularny pyta kiedy przestanie rosnąć telefon.
To jest obraz galaktyki, wspólnej galaktyki ogrodowej, w której znajduje się 100 miliardów gwiazd takich jak nasze Słońce.	This is the picture of a galaxy a common our garden galaxy with what 100 billion stars like our Sun in it.	To zdjęcie galaktyki podobnej do naszej. Jest tam 100 mld. gwiazd podobnych do Słońca.
Postanowiłem więc, że lepiej zrobię to przez kolejny dzień i kolejny, i jeszcze jeden dzień, aż w końcu obiecałem sobie, że przez rok będę milczeć, ponieważ zacząłem się coraz więcej uczyć i musiałem się więcej nauczyć.	And so I decided I’d better do this for another day and another day and another day until finally I promised myself for a year I would keep quiet because I started learning more and more and I needed to learn more.	Więc zdecydowałem że lepiej przeciągnę to jeszcze o dzień i kolejny i kolejny aż w końcu obiecałem sobie że zachowam ciszę przez rok ponieważ zacząłem się uczyć coraz więcej i potrzebowałem nauczyć się więcej.
MA Cóż, myślę, że kiedy jest więcej kobiet, zmienia się ton rozmowy i zmieniają się cele rozmowy.	MA Well I do think when there are more women that the tone of the conversation changes and also the goals of the conversation change.	MA Myślę że kiedy będzie więcej kobiet zmieni się ton konwersacji i jej cele.
Jest kamera.	There is a camera.	To aparat.
Kiedy spojrzysz na origami DNA, możesz zobaczyć, że to, co naprawdę jest, nawet jeśli myślisz, że jest skomplikowane, to wiązka podwójnych helis, które są równoległe do siebie i są trzymane razem przez miejsca, w których krótkie pasma biegną wzdłuż jednej helisy, a następnie skaczą do innego.	When you look at DNA origami you can see that what it really is even though you think it is complicated is a bunch of double helices that are parallel to each other and they are held together by places where short strands go along one helix and then jump to another one.	Na tym obrazie widać że origami DNA Na tym obrazie widać że origami DNA to po prostu równolegle ułożone podwójne helisy to po prostu równolegle ułożone podwójne helisy powiązane w miejscach gdzie krótkie łańcuchy powiązane w miejscach gdzie krótkie łańcuchy łączą dwie helisy.
Dziękuję, że tu jesteście, bo milczałam przez 17 lat.	And I say thank you for being here because I was silent for 17 years.	I mówię że dziękuję wam za bycie tu ponieważ nie odzywałem się przez 17 lat.
Teraz wszyscy w tym pokoju w takiej czy innej formie jesteście prawdopodobnie klientami jednej lub obu z tych organizacji, które się połączyły.	Now all of you in this room in one form or other are probably customers of one or both of those organizations that merged.	Wszyscy na sali w tej czy innej formie są pewnie klientami jednej lub obu organizacji. są pewnie klientami jednej lub obu organizacji.
Tak więc jest to miejsce, w którym Kiva jest dzisiaj, tylko po to, aby przenieść cię do teraźniejszości.	So that is where Kiva is today just to bring you right up to the present.	Abyście byli na bieżąco na tym etapie znajduję się dzisiaj Kiva.
To właśnie tych ludzi chciałbym stworzyć w świecie, który będzie się rozwijał.	It is those people I would quite like to create in the world going forward.	Takich ludzi chciałbym stworzyć w świecie idącym naprzód.
I dokonaliby naprawdę interesujących drobnych zmian w swoim życiu, tak jak zaczęliby posyłać swoje dzieci do szkoły.	And they would make really interesting little adjustments in their lives like they would start to send their children to school.	Wprowadzali niewielkie ulepszenia w ich życiu jak na przykład wysyłając po raz pierwszy dzieci do szkoły.
Wkrótce brakowało żywności, a wielu Holendrów przeżywało zaledwie 500 kalorii dziennie, czyli jedną czwartą tego, co spożywali przed wojną.	Soon food became scarce with many Dutch surviving on just 500 calories a day a quarter of what they consumed before the war.	Wkrótce zaczęło brakować jedzenia wielu Holendrów spożywało jedynie 500 kalorii dziennie jedną czwartą tego co spożywali przed wojną.
To była kolejna rzecz, która naprawdę mnie poruszyła.	That was another thing that really touched me.	To była kolejna rzecz która mnie urzekła.
Uczenie się jest jedną z najważniejszych czynności życiowych i zaczyna się dużo wcześniej, niż kiedykolwiek sobie wyobrażaliśmy.	Learning is one of life is most essential activities and it begins much earlier than we ever imagined.	Nauka jest jedną z najistotniejszych czynności w życiu i rozpoczyna się dużo wcześniej niż sobie kiedykolwiek wyobrażaliśmy.
Pokażę wam dwa filmy, którym ostatnio poświęca się dużo uwagi i które moim zdaniem ucieleśniają tę filozofię.	And I am going to show you two videos that have gotten a lot of attention recently that I think embody this philosophy.	Pokażę wam dwie rzeczy które budzą ostatnio duże zainteresowanie.
Ten ważny wysiłek musi obejmować skupienie się na tym, czego uczą się płody w ciągu dziewięciu miesięcy spędzonych w łonie matki.	That important effort must include a focus on what fetuses learn during the nine months they spend in the womb.	Ten ważny wysiłek powinien skupiać się na tym czego uczy się płód w trakcie dziewięciu miesięcy spędzonych w łonie.
Oto zbliżenie skamieniałości po pięciu latach przygotowań do czyszczenia i opisu, który był bardzo długi i musiałem odsłonić kości z bloku piaskowca, który właśnie pokazałem na poprzednim slajdzie.	Here is a close up of the fossil after five years of cleaning preparation and description which was very long and I had to expose the bones from the sandstone block I just showed you in the previous slide.	Tak wyglądała skamielina po 5 latach czyszczenia preparacji i opisu bardzo długi okres. Musiałem wyłonić kości z bloku piaskowca który widzieliście wcześniej co trwało 5 lat.
Ponieważ prawda jest taka, że ​​każda praca, którą wykonujesz, która wymaga interakcji z innymi ludźmi, jest pracą moralną.	Because the truth is that any work that you do that involves interaction with other people is moral work.	Bo prawda jest taka że każda wykonywana przez nas praca która obejmuje interakcję z innymi ludźmi jest pracą moralną.
Więc co możemy zrobić.	So what can we do.	Więc co możemy zrobić?
Nazywa się to kością gnykową. Jest to kość, która jest tutaj.	This is called the hyoid bone It is a bone which is right here.	To kość gnykowa znajduje się tutaj.
Więc kiedy zaczyna się to przejście.	So when does this transition begin.	Kiedy zacznie się ta zmiana?
Opracowaliśmy plan zwany The One Degree War Plan, nazwany tak ze względu na wymagany poziom mobilizacji i skupienia.	We developed a plan called The One Degree War Plan so named because of the level of mobilization and focus required.	Opracowaliśmy plan zw. Planem Wojny Pierwszego Stopnia  nazwany tak z uwagi na poziom wymaganej mobilizacji i skupienia.
A teraz go nie ma, więc jestem bardzo dziękuję.	And now he is gone and so am I Thank you very much.	I już jej nie ma więc i na mnie czas. Dziękuję bardzo.
Muszą nauczyć się szanować siebie.	They need to learn to respect themselves.	Muszą się nauczyć by siebie szanować.
Ta kwestia dotyczy tego, jak zareagujemy.	This issue is how will we react.	Najważniejsze jak zareagujemy?
Matka natura nie negocjuje, tylko ustala zasady i opisuje konsekwencje.	Mother nature doesn not negotiate she just sets rules and describes consequences.	Matka natura nie negocjuje tylko ustala zasady i wskazuje konsekwencje.
Słusznie.	Fair enough.	Ma to sens.
A oto jego druga rada.	And here is his second bit of advice.	Oto kolejna.
Masz również muchy wielkości much, które są robione przez Roberta Wooda na Harvardzie.	You have also got flies the size of flies that are being made by Robert Wood at Harvard.	Mamy już muchy wielkości much tworzone przez Roberta Wooda z Harvardu.
on nie ma nóg.	he has no legs.	Nie miał nóg.
Teraz nie mogę sobie wyobrazić. Przykro mi, że możesz mieć lepszą wyobraźnię niż ja. Nie wyobrażam sobie utraty ręki i zazwyczaj w wieku 22 lat.	Now I cannot imagine I am sorry you may have a better imagination than I do I can not imagine losing my arm and typically at 22 years old.	Nie wiem jak wy ale ja nie potrafię sobie wyobrazić utraty ręki sobie wyobrazić utraty ręki i to w wieku 22 lat
I to, co mnie interesuje, to nie styl tego, ale związek tego, który wzmacnia tę aktywność.	And what I am interested in is not the styling of that but the relationship of that as it enhances that activity.	Jestem zainteresowany nie tym jak to wystylizować ale relacjami które ulepszają tę aktywność.
Nie próbuję rozwiązywać problemu Bliskiego Wschodu.	I am not trying to solve the Middle East problem.	Nie staram się rozwiązać konfliktu na Bliskim Wschodzie.
Jest to ubranie skóry bez obecności postaci.	It is the clothing the skin without the presence of the character.	To ubranie bezpostaciowa skóra.
Wszystkie te rzeczy idą w parze i jest to szczególnie ważne, aby zrozumieć, kiedy martwimy się płomieniami teraźniejszości, aby mieć oko na przyszłość.	All of these things are coming together and it is a particularly important thing to understand as we worry about the flames of the present to keep an eye on the future.	Wszystkie te rzeczy schodzą się razem i bardzo ważną rzeczą do zrozumienia jest abyśmy myśląc o problemach współczesności nie zapomnieli co szykuje się w przyszłości.
Oznacza to, że za każdego dolara, który zdeponujesz, pożyczasz około dziewięciu lub dziesięciu.	That means for every dollar you deposit it loans out about nine or 10.	To oznacza że na każdego dolara którego zostawiasz w banku on pożycza 9 lub 10.
Ale jeśli stracisz jeden z tych drugich zębów, nie odrosną, chyba że jesteś prawnikiem.	But then if you lose one of those second set of teeth they don not regrow unless if you are a lawyer.	Jednak później jeśli stracicie ten drugi zestaw to zęby już nie rosną no chyba że jesteś prawnikiem.
I z błogosławieństwem Trulszika Rinpocze rozpoczęliśmy pielgrzymkę do ciekawego miejsca w towarzystwie wielkiego lekarza.	And with the blessing of Trulshik Rinpoche we began a pilgrimage to a curious destination accompanied by a great doctor.	Z błogosławieństwem Trulshika Rinpocze rozpoczęliśmy pielgrzymkę do interesującego miejsca w towarzystwie wspaniałego lekarza.
Niższa warstwa mózgu jelita ma swoje własne cele związane z obroną trawienia, a my mamy wyższy mózg, którego celem jest integracja i generowanie zachowań.	The lower layer our gut brain has its own goals digestion defense and we have the higher brain with the goal of integration and generating behaviors.	Niższa warstwa nasz mózg w przewodzie pokarmowym ma swój własny cel obrona i trawienie mamy też wyższy mózg którego celem jest integracja i generowanie zachowań.
Jest to powód do wielkiego optymizmu.	It is something to be greatly optimistic about.	To jest znak aby miec nastawienie bardzo optymistyczne.
Uśmiech Uśmiech Otwórz usta.	Smile Smile Open the mouths.	Uśmiechnijcie się. Otwórzcie usta.
Ponieważ mózgi są drogie.	Because brains are expensive.	Bo mózgi są bardzo drogie.
To nie jest w porządku. Wymaga myślenia.	This is not right It requires thinking.	Tak nie powinno być. To wymaga przemyślenia.
To trochę jak Indianie z Andyjskiego Woodstock 60000 pielgrzymujący do końca polnej drogi, która prowadzi do świętej doliny zwanej Sinakara, w której dominują trzy języki wielkiego lodowca.	It is kind of like an Andean Woodstock 60000 Indians on pilgrimage to the end of a dirt road that leads to the sacred valley called the Sinakara which is dominated by three tongues of the great glacier.	To taki jakby andyjski Woodstock 60 tys. Indian pielgrzymuje na koniec polnej drogi prowadzącej do świętej doliny zwanej Sinakara opanowanej przez trzy języki wielkiego lodowca.
Metafora jest jasna, że ​​wchodzisz w górę jako jednostka, ale poprzez wyczerpanie poprzez poświęcenie wyłaniasz się jako społeczność, która po raz kolejny potwierdziła swoje poczucie miejsca na planecie.	And the metaphor is clear you go into the mountain as an individual but through exhaustion through sacrifice you emerge as a community that has once again reaffirmed its sense of place in the planet.	Metafora jest oczywista wyrusza się na górę jako jednostka ale poprzez wyczerpanie poprzez poświęcenie wyłania się społeczność która raz jeszcze potwierdziła swoje miejsce na planecie.
A to, co najbardziej interesuje zwykłego Afgańczyka, to to, że Clare Lockhart jest tutaj, więc przytoczę dyskusję, którą odbyła z niepiśmienną kobietą w północnym Afganistanie.	And the thing that the ordinary Afghan is most concerned with is Clare Lockhart is here so I will recite a discussion she had with an illiterate woman in Northern Afghanistan.	A sprawa o którą najbardziej martwią się zwykli Afgańczycy to jest tu z nami Clare Lockhart więc przytoczę fragment jej rozmowy z niepiśmienną kobietą z północnego Afganistanu.
A teraz 4000 kościołów dołączyło do ruchu ekologicznego.	And now 4000 churches have joined the environmental movement.	A teraz 4.000 kościołów dołączyło sie do ruchu ekologicznego.
Byliśmy w stanie to zrobić, ponieważ wyszkoliliśmy ludzi w kręceniu filmów, kontynuując naszą pracę i wysyłając naszych filmowców z Wiwy i Arhuaco do ostatnich świętych jezior, aby zrobić ostatnie ujęcia do filmu, a my śledziliśmy resztę Arhuaco z powrotem do morza, biorąc elementy od wyżyn do morza.	We were able to because we had trained people in filmmaking continue with our work and send our Wiwa and Arhuaco filmmakers to the final sacred lakes to get the last shots for the film and we followed the rest of the Arhuaco back to the sea taking the elements from the highlands to the sea.	Ponieważ uprzednio wyszkoliliśmy ludzi w filmowaniu mogliśmy kontynuować naszą pracę i wysłać naszych filmowców Wiwa i Arhuaco do ostatnich ważnych punktów – świętych jezior aby mogli nakręcić ostatnie sceny filmu a następnie podążyliśmy za resztą Arhuaco z powrotem do morza zanosząc tam pierwiastki z gór.
Cóż, przykro mi było wskazać, że czysty człowiek jest umysłem, który w końcu zobaczył to, co było widziane przez długi czas.	Well I was very sorry to point out that the pure man is mind has in fact seen at long last what had been seen for a long time.	Było mi bardzo przykro wytknąć że czysty umysł dopiero na końcu zobaczył to co było widoczne już od dłuższego czasu.
I to była druga wielka para trwająca 100 000 lat i 150000 lat naszej ewolucji.	And that has been the second great couple 100000 years 150000 years flow of our evolution.	I to był drugi wielki kilkuset tysięczny 150000 letni przepływ naszej ewolucji.
I to było jedno z moich głównych odkryć, dzięki którym odkryłem, że te wyspy są mniej więcej takie same jak cała wielka rzecz.	And that was one of my major discoveries to find that these islands were the same as the whole big thing more or less.	Jedna z najważniejszych rzeczy jakie odkryłem to że te wysepki były powtórzeniem całości.
Tak więc ludzkość zawsze była świadoma tego, że istnieją pewne kształty, które mają tę szczególną właściwość, że każda część jest podobna do całości, ale mniejsza.	So the experience of humanity has always been that there are some shapes which have this peculiar property that each part is like the whole but smaller.	Więc z doświadczenia wiadomo było że pewne kształty mają tę osobliwą właściwość ich część jest jak całość tylko mniejsza.
Chropowatość można zmierzyć liczbą 23 12, a czasem znacznie większą.	That one can measure roughness by a number a number 23 12 and sometimes much more.	chropowatość można mierzyć. za pomocą liczby 2.3 1.2 czasem dużo więcej.
Naszą wizją jest lokalna produkcja, podobnie jak lokalny ruch żywnościowy.	Our vision is local manufacturing like the local food movement for production.	Nasza wizja to produkcja lokalna jak lokalne rolnictwo.
I to jest moment, w którym pokrywa sięga z części, kiedy magia naprawdę się zaczyna.	And it is when this lid goes on the part that the magic really starts.	Kiedy pokrywa zatrzaskuje formę dopiero zaczyna działać magia
Jest większy niż tygrys.	It is bigger than a tiger.	Jest większy niż tygrys.
Są wyjątkowymi odpowiedziami na fundamentalne pytanie, co to znaczy być człowiekiem i żyć.	They are unique answers to a fundamental question what does it mean to be human and alive.	Jedyne w swoim rodzaju odpowiedzi na zasadnicze pytanie co to znaczy być człowiekiem i co to znaczy żyć?
Musisz przyznać, że to niezła praca detektywa starca na randce.	You have to admit that is a pretty boss piece of detective work for an old man on a date.	Musicie przyznać że to niezła dedukcja jak na staruszka na randce.
Wierzymy, że stawka jest wysoka, ale zwroty będą jeszcze większe.	We believe that the stakes are high but that the returns will be even greater.	Zdajemy sobie sprawę że stawka jest wysoka ale zyski będą jeszcze większe.
Jedną z nich jest to, że Sally Clark była niewinna, co jest a priori ogromnym prawdopodobieństwem, że większość matek nie zabija swoich dzieci.	One of them is that Sally Clark was innocent which is a priori overwhelmingly likely most mothers don not kill their children.	Jedno mówi że Sally Clark była niewinna i to a priori jest bardzo prawdopodobne większość matek nie zabija swoich dzieci.
I wtedy to się stało.	And that is when it happened.	Wtedy się to wydarzyło. Starsza para szła ulicą .
Musisz pomyśleć i zadam ci kilka pytań.	You have got to think and I am going to ask you some questions.	Zadam Wam kilka pytań więc ruszcie głowami.
Albo nawet wyzwania państw narodowych w nowoczesnej gospodarce światowej.	Or even the challenges of nation states in the modern global economy.	Ani nawet o wyzwaniach globalnej gospodarki.
To tak, jakby powiedzieć, że jeśli rzucisz monetą i zdobędziesz głowę za pierwszym razem, to nie wpłynie to na szansę na zdobycie orła za drugim razem.	It is like saying If you toss a coin and get a head the first time that won not affect the chance of getting a head the second time.	To stwierdzić przy rzucaniu monetą że pierwszy wynik nie wpływa na prawdopodobieństwo następnego.
Powinniśmy przynajmniej to zdawać sobie sprawę, a raczej tego nie robimy.	At the very least we should recognize that and we tend not to.	Powinniśmy to sobie uświadomić.
Czekasz z zapartym tchem na ostatni rzut.	You are waiting with bated breath for the final toss.	Czekacie na ostatni rzut.
Do końca stulecia świat prawdopodobnie straci jedną trzecią gruntów ornych.	The world is likely to lose one third of its arable land by the end of the century.	Światu grozi utrata jednej trzeciej ziem uprawnych przed końcem stulecia.
Odtworzę dwa klipy Ushera, jeden, który jest normalny, i drugi, który prawie nie ma wysokich częstotliwości, prawie żadnych niskich częstotliwości, a nawet tak wielu średnich częstotliwości.	I am going to play you two clips of Usher one which is normal and one which has almost no high frequencies almost no low frequencies and not even that many mid frequencies.	Puszczę wam dwa fragmenty piosenki Usher a jeden normalny i drugi który niemal nie zwiera wysokich i niskich częstotliwości nawet niezbyt wiele środkowych częstotliwości.
Myślę, że ważne jest, aby spojrzeć na te zdjęcia ptaków i zrozumieć, co się z nami dzieje.	I think it is important to kind of look at these pictures of the birds and understand what happens to us.	Moim zdaniem trzeba spojrzeć na te zdjęcia ptaków żeby zrozumieć co się z nami dzieje.
Okej, więc ten facet wciąż jest z nami.	Okay so that guy is actually still with us.	A więc ten facet jest wciąż żywy dla nas.
Gorąco polecam, abyś miał kiedyś okazję zobaczyć spalanie się ropy, ponieważ już nigdy nie będziesz musiał słuchać kolejnego wykładu politycznego na temat geopolityki ropy.	I highly recommend that you get a chance to see crude oil burn someday because you will never need to hear another poli sci lecture on the geopolitics of oil again.	Wielce polecam żebyście kiedyś zobaczyli jak płonie ropa naftowa zamiast słuchać kolejnych wykładów polityczno naukowych o geopolityce tego surowca.
Cóż, Przejście Północno-Zachodnie już tam jest.	Well the Northwest Passage is already there.	No więc Przejście znaleziono.
Masz te zdjęcia ptaków.	You have these pictures of birds.	Takie zdjęcia ptaków.
Pytanie brzmi więc, czy odpowiemy na to, czy nie.	So the question is Will we respond to this or not.	Pytanie brzmi czy zareagujemy?
Jest to forma, jeśli lubisz ekologiczny altruizm, może coś w tym rodzaju. Może to jest to.	It is a form if you like of ecological altruism perhaps something along those lines Maybe it is that.	To forma że tak to nazwę altruizmu ekologicznego czy czegoś podobnego. Może dokładnie tego.
Sugeruję, że dzięki treningowi można nadać muzycznemu dźwiękowi znaczenie nawet u kota.	I am suggesting that with training you can imbue a musical sound with significance even in a cat.	Sugeruję że poprzez trening można wpoić muzykę nawet kotu.
Dopiero teraz inwestycje nie będą polegały na nieustępliwym i bezmyślnym dążeniu do wzrostu konsumpcji.	Only now investment isn not going to be about the relentless and mindless pursuit of consumption growth.	Tyle że teraz inwestowanie nie będzie polegało na niekończącej się i bezmyślnej pogoni za wzrostem konsumpcyjnym.
Czy możemy uzyskać samoreplikujące się zachowanie typu.	Can we get self replicating type behavior.	Czy możemy uzyskać zachowania typu samo powielania?
Jeśli jest eliptyczny, możesz zrobić soczewkę astygmatyczną.	If it is elliptical you can make an astigmatic lens.	Jeśli eliptyczne można zrobić soczewki astygmatyczne.
Ludzie są tak zaangażowani, że i tak mają ochotników, tak jak wolontariusze polityczni, którzy wachlują się na wsi, walcząc o swojego kandydata.	People become so engaged that they have volunteers just like political volunteers anyway who fan out over the countryside campaigning for their candidate.	Ludzie tak się angażują że dobrowolnie podobnie jak wolontariusze partii politycznych wyruszają w szeroki kraj agitując dla swojego kandydata.
Zasadniczo zastępujemy w naszym życiu dostęp do tego, czego chcemy.	Basically we substitute in our lives access to the things we want.	Przede wszystkim tworzymy w naszym życiu dostęp do rzeczy których chcemy.
I to jest mniej futurystyczne, niż mogłoby się wydawać.	And this is less futuristic than it may sound.	I choć brzmi to jak science fiction
Saul Griffith o codziennych wynalazkach.	Saul Griffith on everyday inventions.	Saul Griffith o codziennych wynalazkach.
Następnie nakładasz na to membranę i wywierasz nacisk, aby było to częścią dodatkowego programu.	You then put a membrane on that and you apply pressure so that is part of the extra program.	Następnie wkłada się na to membranę i przykłada ciśnienie to część dodatkowego programu.
Cóż, prawdopodobnie rozpoznajesz pierwszą osobę.	Well you probably recognize the first person.	Pewnie poznajecie pierwszą osobę.
Słyszałem, jak mówiono, że utonięcie jest najspokojniejszą śmiercią, jaką można mieć.	I have heard it said that drowning is the most peaceful death that you can have.	Słyszałem kiedyś że utonięcie to najspokojniejsza śmierć.
Panie i panowie, podzielam wasze cele.	Ladies and gentlemen I share your goals.	Panie i panowie Współdzielę waszą misję.
W każdym kraju jest naprawdę inaczej.	And it is really different within each country.	Różni się to bardzo w skali kraju.
Pęknięcia są zbyt małe, aby wbić w nie palce, więc jedynym sposobem na wspinanie się jest użycie czubków palców w pęknięciach i użycie przeciwnego nacisku i zmuszenie się do wstania.	The cracks are too small to get your toes into so the only way to climb is using your fingertips in the cracks and using opposing pressure and forcing yourself up.	Szczeliny są jednak zbyt małe na stopy więc jedyny sposób wspinania to włożenie opuszków palców w szczelinki i rozpieranie się aby się wznosić.
Chciałbym pokazać, co dzieje się z danymi, co możemy pokazać za pomocą tych danych.	I would like to show you what happens with the data what we can show with this data.	Chciałbym Wam pokazać co dzieje się z tymi danymi co możemy za pomocą tych danych pokazać.
Po prostu absolutnie zachwyca najmłodszych.	Just absolutely delights the little ones.	Ku uciesze dzieciaków.
A jaka jest wtedy definicja Definicja.	And what is the definition then The definition.	No ale jaka jest definicja? Definicja?
To jest wspinaczka na tarcie w Tuolumne Meadows w górach Yosemite.	This is a friction climb up in Tuolumne Meadows in the Yosemite high country.	To jest wejście na tarcie w Tuolumne Meadows na wyżynie Yosemite.
I to sprawiło, że pomyślałem, że być może agencje darczyńców właśnie przegapiły kluczowy aspekt marketingowego zrozumienia, kto jest odbiorcą.	And this made me think that perhaps the donor agencies had just missed out on a key aspect of marketing understanding who is the audience.	I to skłoniło mnie do myślenia że może darczyńcy pominęli kluczowy aspekt marketingu zrozumienie kto jest odbiorcą.
Myślą o tym, jak zrzucić ciężar na swoje stopy, ponieważ to całkiem naturalne, że noszą cię przez cały dzień.	They think about how to get the weight over their feet because it is sort of natural they carry you all day long.	Myślą o tym jak przenieść swój ciężar na stopy bo jest to w pewnym sensie naturalne. Nogi dzwigają nas cały dzień.
Aby naprawdę to zrozumieć, musisz powiedzieć „Och, rozumiem”.	To really understand it you have got to say Oh I get it.	By to naprawdę zrozumieć musisz sobie powiedzieć O! Już łapię!
I jest to rząd Stanów Zjednoczonych w najlepszym wydaniu, bez rzecznictwa, które dostarcza faktów, że jest to użyteczne dla społeczeństwa.	And it is US government at its best without advocacy providing facts that it is useful for the society.	To jest Rząd Amerykański w najlepszym wydaniu bezstronny dostarczający informacje które służą ludziom.
Mówię O nie, kontynuuję.	I say Oh no I continue.	Powiedziałem sobie o nie robię to dalej.
Ten konkretny, który został mi podarowany, znajduje piłki golfowe, zwłaszcza jeśli jesteś na polu golfowym i sprawdzasz pod wystarczającą ilością krzaków.	This particular one that was given to me finds golf balls especially if you are at a golf course and you check under enough bushes.	To konkretne urządzenie które zostało mi podarowane znajduje piłeczki do golfa zwłaszcza jeśli jesteś na polu golfowym i sprawdzisz wystarczającą liczbę krzaków.
A ja miałem swój w kieszeni.	And I had mine on my pocket.	Swój telefon miałem w kieszeni.
Tniemy na sucho i pakujemy je, montujemy na teczce.	We cut we dry and we packed them we mounted them on a folder.	Ścinaliśmy je suszyliśmy i umieszczaliśmy w folderach
A tak przy okazji, rozróżnienie między łagodzeniem nieszczęścia a budowaniem szczęścia jest niezwykle ważne.	And by the way the distinction between relieving misery and building happiness is extremely important.	Przy okazji różnica między niesieniem ulgi a wywoływaniem szczęścia jest bardzo ważna.
I straciła zainteresowanie nim i wróciła do tego, co robi najlepiej.	And lost interest with him and went back to what she does best.	I przestała się nim interesować i wróciła do tego co robi najlepiej.
Widzę, że skały są tutaj.	I can see the rocks are over here.	Widzę skały tutaj.
Ale hej przynajmniej jest higieniczny.	But hey at least it is hygienic.	Ale to przynajmniej higieniczne.
To jedyne spodnie i koszula mi o tym przypominają.	This is the only trouser and shirt remind me of this.	To jedyne spodnie i T shirt które mi o tym przypominają.
Jennifer Good.	Jennifer Good.	Jennifer Pozytywne.
Musi to być jeden inteligentny szczeniak, który potrafi samodzielnie nawigować i podejmować decyzje w obcym oceanie.	It needs to be one smart puppy able to navigate and make decisions on its own in an alien ocean.	Musi być sprytny musi umieć sam pływać oraz sam podejmować decyzje w obcym oceanie.
Amy Tan o kreatywności.	Amy Tan on creativity.	Amy Tan na temat inwencji twórczej.
Gdybym wiedział, kiedy byłem młody, że zabijając słonia niszczę bioróżnorodność, nie zrobiłbym tego.	If I know when I was young that by killing an elephant I am destroying biodiversity I would not have done it.	Gdybym w młodości wiedział że zabijając słonia niszczę bioróżnorodność nie zrobiłbym tego.
Tak więc David jest pięcioma najważniejszymi wskazówkami dotyczącymi prezentacji.	So David is top five presentation tips.	Oto 5 wskazówek Davida .
Tutaj Gates robi coś dla Windowsa.	Here is Gates doing a thing for Windows.	Oto Gates coś przedstawia.
Zacznij od poinformowania ich, jaki jest rynek.	Start with telling them what the market is.	Zacznij od opisania sytuacji rynkowej i twojego planu.
Ilu z nich miało okazję wyjechać do USA, tak jak ja.	How many have got opportunity like me to go to US do a master is.	Jak wiele osób miało taką możliwość jak ja by wyjechać do USA i uzyskać tytuł magistra?
Ma 96 czujników 36 komputerów pokładowych 100000 linii behawioralnego kodu autonomii zawiera ponad 10 kilogramów TNT w elektrycznym ekwiwalencie pokładowym.	It is got 96 sensors 36 onboard computers 100000 lines of behavioral autonomy code packs more than 10 kilos of TNT in electrical onboard equivalent.	Ma 96 czujników 36 komputerów pokładowych 100 tys. linijek kodu autonomii behawioralnej może pomieścić ponad 10 kg trotylu.
Oto fragment z filmu National Geographic, który ukazał się w 1999 roku.	Here is a clip from a National Geographic movie that came out in 1999.	Mam tutaj fragment filmu National Geographic który ukazał się w 1999 roku.
Czasami jesteś wyposażony w umiejętności, ale niekoniecznie są to umiejętności umożliwiające kreatywność.	And sometimes you are equipped with skills but they may not be the kind of skills that enable creativity.	A czasami jesteśmy wyposażeni w umiejętności tylko że to mogą nie być takie umiejętności które umożliwią kretywność.
Jeśli gramy więcej, rozwijamy większą dojrzałość emocjonalną.	We develop more emotional maturity if we play more.	Osiągamy większą dojrzałość emocjonalną jeśli bawimy się więcej.
Tak więc konsumenci i ja nie mamy na myśli tylko ludzi, którzy kupują rzeczy w Safeway, mam na myśli ludzi z Departamentu Obrony, którzy mogą coś kupić, lub ludzi u ciebie, którzy znają nowojorczyka, który może wydrukować twój artykuł.	So consumers and I don not just mean people who buy stuff at the Safeway I mean people at the Defense Department who might buy something or people at you know the New Yorker who might print your article.	A więc klienci to już nie są tylko ludzie kupujący w Safeway u Klienci dzisiaj to ludzie z np. Ministerstwa Obrony którzy mogą coś od nas kupić albo z New Yorkera którzy mogą wydrukować twój artykuł.
I powiedzieli: Ha, nie będzie ani jednej chwili w harmonogramie.	And they said Ha There won not be a single moment in the schedule.	A oni odpowiedzieli Ha! Nie będzie ani jednej takiej chwili w planie.
Jednym z takich miejsc było miejsce zwane Tiger Beach na północnych Bahamach, gdzie rekiny tygrysie gromadzą się w płytkiej wodzie.	One of the locations was this place called Tiger Beach in the northern Bahamas where tiger sharks aggregate in shallow water.	Jednym z nich była Plaża Tygrysów na północnych Bahamach gdzie rekiny tygrysie zbierają się w płytkich wodach.
I pojechałem na wyspę Bimini na Bahamach, aby pracować ze szczeniętami rekina cytrynowego.	And I went to the island of Bimini in the Bahamas to work with lemon shark pups.	Pojechałem na wyspę Bimini na Bahamach by pracować z młodymi żarłaczami żółtymi.
Chciałem zakończyć ten program opowieścią o nadziei, którą zrobiłem na temat rezerwatów morskich jako pewnego rodzaju rozwiązanie problemu przełowienia w kontekście globalnego kryzysu rybnego.	And I wanted to close this program with a story of hope a story I did on marine reserves as sort of a solution to the problem of overfishing the global fish crisis story.	Chcę zakończyć tą prelekcję nutą nadziei opowieścią o morskich rezerwatach jako o rozwiązaniu problemu nadmiernego połowu ryb.
Ale wiesz, że tysiące innych skórzastych każdego roku nie ma tyle szczęścia, a przyszłość gatunku jest w wielkim niebezpieczeństwie.	But you know thousands of other leatherbacks each year are not so fortunate and the species' future is in great danger.	Ale tysiące żółwi każdego roku nie mają tyle szczęścia a przyszłość gatunku jest w niebezpieczeństwie.
A to zaczyna zdejmować ze świata wielki ciężar, jest biedny.	And that begins to lift a heavy burden off the world is poor.	To pomoże usunąć brzemię obciążające najbiedniejszych.
Pracowałem w innych częściach Nowej Zelandii, a także w pięknych, delikatnych obszarach chronionych, takich jak Fiordland, gdzie znaleziono tę kolonię morską.	I worked in other parts of New Zealand as well in beautiful fragile protected areas like in Fiordland where this sea pen colony was found.	Byłem też w innych zakątkach Nowej Zelandii na pięknych kruchych i chronionych obszarach jak Fiordland gdzie odkryto kolonię koralowców.
To jest zrobione przeze mnie zdjęcie lotnicze przedstawiające Zatokę Świętego Wawrzyńca podczas sezonu na foki harfowe.	This is an aerial picture that I made that shows the Gulf of St Lawrence during harp seal season.	To zdjęcie z lotu ptaka pokazuje Zatokę Św. Wawrzyńca w sezonie na foki grenlandzkie.
Nasze systemy edukacji zbudowaliśmy na wzór fast foodów.	We have built our education systems on the model of fast food.	Budujemy systemy edukacji na modelu fast foodów.
A potem zaczęliśmy sadzić tylko 1000 drzew dziennie.	And then we started planting only 1000 trees a day.	Potem zaczęliśmy sadzić zaledwie 1000 drzew dziennie.
Reforma nie ma już sensu, ponieważ jest to po prostu ulepszenie zepsutego modelu.	Reform is no use anymore because that is simply improving a broken model.	Ulepszanie już nie pomaga. Ulepszanie złego systemu nie ma sensu.
A to jest notatka akupunktury lub IM Pei to Niektóre małe mogą uczynić miasto lepszym.	And this is an acupuncture note or IM Pei is Some small ones can make the city better.	A to jest przykład akupunktury. Albo I.M. Pei. Czasem drobne rzeczy mogą uczynić miasto lepszym.
Oznacza to, że musiałem nauczyć się każdego aspektu ręcznego wytwarzania ceramiki.	That means I had to actually learn every aspect of making pottery by hand.	To znaczy że musiałam nauczyć się wszystkiego o ręcznym wyrabianiu ceramiki.
I że to oczywiście jeden z tematów dla nas jest to, że uważamy, że szczerość i brutalna szczerość mają kluczowe znaczenie dla nas jako wspólnych wspaniałych rodziców.	And that this of course one of the themes for us is that we think that candor and brutal honesty is critical to us collectively being great parents.	I oczywiście jednym z naszych tematów przewodnich jest to że uważamy że otwartość i brutalna szczerość są niezwykle istotne byśmy wspólnie mogli być świetnymi rodzicami.
To jest nadal w Metropolitan Museum, teraz na sprzedaż.	This is still at the Metropolitan Museum now for sale.	To wciąż można kupić w Metropolitan Museum.
I coraz bardziej jestem przekonany, że jest to nie tylko rozwiązanie dla kraju, ale także rozwiązanie problemu zmian klimatycznych.	And more and more I am convinced that it is not only a solution for a country but it is a solution for the problem of climate change.	Jestem coraz bardziej przekonany że jest to rozwiązanie nie tylko dla poszczególnych krajów ale także dla problemu zmian klimatycznych.
Zebraliśmy pieniądze i cieszymy się, że to zrobiliśmy, ponieważ w tej fazie życia niewiarygodnie rzadkim zasobem jest czas.	We raised the money and we are thrilled that we did because in this phase of one is life the incredibly scarce resource is time.	Zebraliśmy pieniądze i jesteśmy bardzo zadowoleni że to zrobiliśmy bo na tym etapie życia nadzwyczaj cennym zasobem jest czas.
Curitiba Rio to jak całowanie się dwóch ptaków.	Curitiba Rio it is like two birds kissing themselves.	Kurytyba i Rio są jak dwa całujące się ptaszki.
Ostatecznie zacząłem od doświadczenia.	Ultimately I started with the experience.	Właściwie zaczynałem już z doświadczeniem.
Przekierowaliśmy 148 milionów funtów, czyli 74000 ton zużytego dywanu ze składowisk, zamykając pętlę przepływu materiałów poprzez logistykę zwrotną i technologie recyklingu poużytkowego, które nie istniały, kiedy zaczynaliśmy 14 lat temu.	We have diverted 148 million pounds that is 74000 tons of used carpet from landfills closing the loop on material flows through reverse logistics and post consumer recycling technologies that did not exist when we started 14 years ago.	Obróciliśmy 148 milionów funtów to jest 74.000 ton używanych dywanów z wysypisk śmieci zamykając pętlę przepływu materiałów dzięki odwrotnej logistyce i technologiom recyklingowym które nie istniały kiedy zaczęliśmy 14 lat temu.
Lepszy model biznesowy to lepszy sposób na większe zyski.	A better business model a better way to bigger profits.	Lepszy model biznesu. Lepszy sposób na większe zyski.
Dziś profesjonalną społeczność teatralną definiuje nie tylko Shaw i Stratford Festivals, ale także Cornerstone Theatre of Los Angeles, kolektyw artystów, który po 11 września zgromadził 10 różnych wspólnot religijnych, katolików Bahia, muzułmanów, Żydów, a nawet rdzennych Amerykanów i wspólnoty wiary gejów i lesbijek, pomagając im tworzyć własne indywidualne sztuki i jedną masową zabawę, w której badali różnice w ich wierze i znaleźli podobieństwo jako ważny pierwszy krok w kierunku uzdrowienia między społecznościami.	Today is professional theater community is defined not only the Shaw and Stratford Festivals but by the Cornerstone Theater of Los Angeles a collective of artists that after 9/11 brought together 10 different religious communities the Bahia the Catholic the Muslim the Jewish even the Native American and the gay and lesbian communities of faith helping them create their own individual plays and one massive play where they explored the differences in their faith and found commonality as an important first step toward cross community healing.	Dziś profesjonalny teatr definiowany jest nie przez festiwale Shaw czy Stradford ale przez Cornerstone Thearter w Los Angeles kolektyw który po wydarzeniach 9/11 zjednoczył 10 różnych społeczności religijnych Bahia Katolików Muzułmanów Żydów nawet Indian oraz gejowskie i lesbijskie społeczności pomagając im tworzyć własne sztuki i jedną wspólną sztukę w których odkrywali różnice swoich wyznań i odnajdywali wspólnotę jako pierwszy ważny krok ku wspólnemu gojeniu ran.
I to stało się nagłówkiem artykułu z magazynu Fortune.	And that became the headline of a Fortune article.	I to zostało nagłówkiem artykułu w Fortune.
Teraz matematyczny umysł natychmiast zauważy, że T w liczniku zwiększa wpływ, ale T w mianowniku zmniejsza wpływ.	Now the mathematically minded will see immediately that T in the numerator increases impact a bad thing but T in the denominator decreases impact.	Teraz uzdolnieni matematycy zobaczą od razu że T w liczniku zwiększa wpływ zła rzecz. Ale T w mianowniku zmniejsza wpływ.
Nadużywanie binging steroidów i tak dalej.	Abuse of steroids binging and so on.	Nadużycie steroidów kompulsywna żarłoczność i temu podobne.
Być może masz informatyka, który jest geniuszem.	Perhaps you have a computer scientist who is a genius.	Może mamy do czynienia z informatykiem naukowcem który jest geniuszem.
Mówi, że mam coś innego, ale może to nie być dla ciebie.	And he says I have got something else but it may not be for you.	Mówi Mam coś innego ale może to nie dla ciebie.
A potem, tak jak teraz, było to piękne miejsce na bale i punki pięknych ludzi, z których wielu wzięło sobie do serca Ronalda Reagana, to komentarz, że nawet jeśli mówią, że ciężka praca nie szkodzi ci, dlaczego ryzykujesz.	And then as now it was a beautiful place of balls and punts beautiful people many of whom took to heart Ronald Reagan is comment that even if they say hard work doesn not do you any harm why risk it.	Wówczas jak i dziś było to cudne miejce pełne bali przejażdżek łodziami pięknych ludzi z których wielu wzięło sobie do serca komentarz Ronalda Regana że “nawet jeśli mówi się iż ciężka praca nikomu jeszcze nie zaszkodziła po cóż ryzykować? ”.
Firma nie odniosła sukcesu i nie mógł spłacić pieniędzy, a ja byłem poręczycielem banknotu, więc miałem dług w wysokości 100 000 USD i zauważyłem, że nagroda Kramer za lot z napędem ludzkim, która była wtedy dostępna przez 17 lat, wynosiła 50000 funtów, co po kursie wymiany wynosiło zaledwie około 100000 dolarów.	The company did not succeed and he couldn not pay the money back and I was the guarantor of the note So I had a $100000 debt and I noticed that the Kramer prize for human powered flight which had then been around for 17 years at the time was 50000 pounds which at the exchange rate was just about 100000 dollars.	Firma nie wypaliła a on sam nie był w stanie zwrócić tej kwoty a ja przecież żyrowałem jego pożyczkę. Stałem się więc posiadaczem długu na 100 tys. dolarów. Odkryłem że nagroda Kramera za lot napędzany siłą ludzkich mięśni która była przyznawana wtedy już od 17 lat wynosiła 50 tys. funtów co po przeliczeniu dawało około 100 tys. dolarów.
Wysyła z powrotem do operatora obrazy wideo o wysokiej rozdzielczości.	It sends high resolution video pictures back to the operator.	Wysyła do operatora nagrania wysokiej jakości
Możesz też wsiąść do samolotu i polecieć do Szanghaju, w kolejce przed Shandą, gdzie biura kosztują prawdopodobnie 600 700 dolarów i odzyskaj swoją postać, odzyskaj historię.	Or you can get on a plane fly to Shanghai queue up outside Shanda is offices cost probably 600 700 dollars and reclaim your character get your history back.	albo lecimy do Szanghaju i stajemy w kolejce przed biurem Shandy co kosztuje ok. 600 700 dolarów. Tak można odzyskać postać z historią gry.
To była jedyna szansa, że ​​musiałem się skupić na tym, o co mi chodzi i co jest ważne. Ku mojemu zdziwieniu zdałem sobie sprawę, jak ważne są kwestie środowiskowe, którym Charles Lindbergh poświęcił ostatnią trzecią część swojego życia, a przygotowanie tego artykułu wiele mi zrobiło dobrego.	This was the one chance that I had to focus on what I really was after and what was important And to my surprise I realized the importance of environmental issues which Charles Lindbergh devoted the last third of his life to and preparing that paper did me a lot of good.	To był moment w którym musiałem skupić się na tym czego tak naprawdę chciałem i co było ważne. Ku mojemu zdziwieniu uświadomiłem sobie powagę problemów związanych ze środowiskiem na które Charles Lindbergh poświęcił 1/3 swojego życia i przygotowywanie tego referatu bardzo dobrze na mnie wpłynęło.
Nie znałem serwisu eBay z tego słoika z wodą siedzącego na tym pianinie, ale miałem na tyle przytomności umysłu, aby wrócić i porozmawiać z jednym z dzieciaków technicznych w moim centrum.	I didn not know eBay from that jar of water sitting on that piano but I had the presence of mind to go back and talk to one of the techie kids at my center.	Nie wiedziałem nic o eBay i nie potrafiłbym jej odróżnić od chociażby tego słoika co na fortepianie stoi. Ale zachowałem wystarczającą przytomność umysłu by pogadać o tym z jednym z obeznanych technicznie dzieciaków z mojego ośrodka.
Będą też ogromne argumenty zawodowe.	There will be huge professional arguments as well.	Będą również dyskusje wśród profesjonalistów.
To zostało spalone podczas zamieszek, które znajdują się obok mojego budynku, więc zbudowałem kolejny karton i ponownie wyszedłem na ulicę.	This was burned out during the riots this is next to my building and so I had another cardboard box built and I walked back out in the streets again.	Ten budynek został spalony podczas zamieszek leży tuż obok mojego budynku. Tak więc zleciłem komuś stworzenie kolejnej kartonowej makiety i wyszedłem z nią na ulice.
Robią więc te wszystkie niesamowite rzeczy, które pomagają nam i są niezbędne do utrzymania nas przy życiu i nigdy nie mają na to żadnej presji.	So they do all these amazing things that help us and are vital for keeping us alive and they never get any press for that.	Zatem wykonują wszystkie te niewiarygodne rzeczy które pomagają nam i są niezbędne żeby utrzymać nas przy życiu ale o tym nikt nie mówi.
Więc zamykają się w tych receptorach i blokują rozpoznawanie prawdziwej rzeczy.	And so they lock into those receptors and they jam recognition of the real thing.	A więc dopasowują się do receptorów i blokują rozpoznawanie tych prawdziwych.
PM I Tyler jest tutaj, aby pokazać wam Walkalong.	PM And Tyler is here to show you the Walkalong.	PM Tyler jest dziś z nami żeby pokazać ten szybowiec.
A obecny układ scalony może mieć w każdym z tych chipów około miliarda tranzystorów, z których wszystkie muszą za każdym razem działać idealnie.	And a current integrated circuit might have in each one of these chips something like a billion transistors all of which have to work perfectly every time.	Obecnie układ scalony może zawierać w każdym z tych chipów około miliarda tranzystorów każdy perfekcyjnie działający.
Tak więc prostota i przewidywalność są cechami prostych rzeczy.	So simplicity and predictability are characteristics of simple things.	Więc prostota i przewidywalność to cechy rzeczy prostych.
Musimy powiedzieć, że jest bardzo dobrym kolegą Einsteina.	He is a very good colleague of Einstein is we must say.	Można powiedzieć że jest on bardzo dobrym kolegą Einsteina.
Powiedz nam, Charlie, dlaczego powiedziałeś, że powinien móc korzystać z wózka golfowego.	Tell us Charlie why would you say he should be able to use a golf cart.	Powiedz nam Charlie dlaczego Casey powinien dostać wózek golfowy?
Ale Piotr Arystoteles nie zgadza się z tobą, że to jest powód.	But Peter Aristotle doesn not agree with you that that is the reason.	Ale Peter Arystoteles nie zgodziłby się z tobą.
Pomyślałem więc, że pożyteczne może być przypomnienie nam o niektórych rzeczach, które tu się wydarzyły, a następnie może zaproponowanie kilku pomysłów, które możemy zabrać, rozwinąć i nad nimi popracować.	So I thought that what may be useful is to remind us of some of the things that have gone on here and then maybe offer some ideas which we can take away and take forward and work on.	Uznałam że warto przypomnieć o niektórych poruszonych sprawach i podsunąć myśl którą da się zabrać ze sobą i rozwinąć w przyszłości.
Więc to, co chciałbym dzisiaj zrobić, to odbyć dyskusję.	So what I would like to do today is have something of a discussion.	Dlatego chciałbym dzisiaj to przedyskutować.
Wtedy sprzeciw wobec uczciwości znika.	Then the fairness objection goes away.	Wtedy zarzut nie ma sensu.
I przybywa do miasta. Jest złamanym człowiekiem.	And he comes to the town He is a broken person.	Przybywa do miasta. Jest wrakiem człowieka.
Po pierwsze, żaden prawdziwy fan sportu nie mówiłby w ten sposób.	First no real sports fan would talk that way.	Po pierwsze żaden fan się z nim nie zgodzi.
OK, odkryliśmy cząstki, ale jeśli nie rozumiesz przyczyny leżącej u podstaw tego wzoru, wiesz, dlaczego jest on zbudowany w taki sposób, w jaki jest w rzeczywistości. Zbierałeś znaczki. Nie zajmowałeś się nauką.	OK we have discovered the particles but unless you understand the underlying reason for that pattern you know why it is built the way it is really you have done stamp collecting You haven not done science.	Ok odkryliśmy cząstki lecz jeśli nie zrozumiemy podstawowych założeń dla tego wzoru dlaczego jest zbudowany w ten sposób jedyne czego dokonaliśmy to zbieranie znaczków to nie nauka.
A potem jest improwizowanie w skali ćwierćnutowej metronomu prawej ręki naukowo bardzo bezpieczne, ale muzycznie naprawdę nudne.	And then there is improvising on a scale quarter notes metronome right hand scientifically very safe but musically really boring.	A jest też improwizacja na bazie skali ćwierćnuty metronom prawa ręka naukowo bardzo bezpieczne ale muzycznie bardzo nudzące.
Ale są ludzie, kobiety, które tworzą miejsca pracy.	But there are people women creating jobs.	Ludzie kobiety tworzą miejsca pracy.
Ale chcę, żebyście zdali sobie sprawę, że zasoby w rękach afrykańskich kobiet to potężne narzędzie.	But I want you to realize that resources in the hands of African women is a powerful tool.	Chcę wam uświadomić że środki w rękach Afrykanek to potężne narzędzie.
Irlandia jest obecnie jedną z najszybciej rozwijających się gospodarek w Unii Europejskiej.	Ireland is one of the fastest growing economies in the European Union today.	Ich gospodarka jest jedną z najszybciej rozwijających sie w Unii.
A muzycy w końcu czuli się dobrze.	And the musicians they were comfortable in the end.	A muzycy koniec końców czuli się komfortowo.
Myślę więc, że po kilku pokoleniach i oto pomysł, że naprawdę mamy krzesiwo.	So I think after several generations and here is the idea we really have a tinderbox.	Po wielu pokoleniach mamy tykającą bombę zegarową.
To jest krótki film pokazujący, jak wykonaliśmy ten projekt.	This is a short video of how we did this project.	Oto krótki filmik o tym jak realizowaliśmy ten projekt.
Czy nasi prezydenci i nasi przywódcy, o których wszyscy mówią, kiedykolwiek zwołali tych ludzi i powiedzieli „Spójrz na swoją fundację i swoją fundację”, że masz tyle pieniędzy, że jesteśmy wdzięczni.	Have our presidents and our leaders everyone is talking about have they ever called these people together and said Look your foundation and your foundation you have so much money we are grateful.	Czy nasi prezydenci i liderzy zwołali kiedyś tych ludzi i powiedzieli Wasza fundacja ma duże środki za co jesteśmy wdzięczni.
H oznacza cząstkę Higgsa.	H stands for Higgs particle.	H oznacza cząstkę Higgsa.
Ale dziś kobiety odbudowują Ruandę.	But today women are rebuilding Rwanda.	Ale dziś kobiety odbudowują Rwandę
Przechodząc do niektórych aplikacji opracowanych przez programistów i badaczy na całym świecie z robotami i prostymi maszynami, na przykład w tym przypadku latanie zabawkowym helikopterem po prostu myśląc o podnoszeniu umysłem.	And moving on to some applications developed by developers and researchers around the world with robots and simple machines for example in this case flying a toy helicopter simply by thinking lift with your mind.	Jeśli chodzi o aplikacje rozwinięte przez deweloperów i badaczy na całym świecie z robotami i prostymi maszynami na przykład tutaj latanie zabawkowym helikopterem po prostu myśląc podnieś .
Byłem mięczakiem.	I was a wimp.	Byłem mięczakiem.
Tutaj mamy to działające w trybie dużej prędkości.	Here we have it running at high speed mode.	Puszczamy to tu w wielkim spowolnieniu.
Ale przy ograniczonym czasie, jaki mamy, chciałbym pokazać ci pakiet poznawczy, który jest zdolnością do zasadniczo przenoszenia wirtualnych obiektów za pomocą umysłu.	But with the limited time we have available I would like to show you the cognitive suite which is the ability for you to basically move virtual objects with your mind.	Ale przy ograniczonym czasie jaki mamy chciałabym pokazać wam zestaw poznawczy którym jest możliwość poruszania wirtualnym przedmiotem przy pomocy waszego umysłu.
Wrzucam resztki jedzenia do tego odwadniającego suszącego maceratora, który zamienia żywność w materiał wewnętrzny, który mogę później przechowywać, a następnie kompostować.	I put my food waste into this dehydrating desiccating macerator turns food into an inner material which I can store and then compost later.	Odpadki spożywcze trafiają do suszącej rozdrabniarki która przemienia je w materiał odpadkowy zdatny do przechowania i na kompost.
Przez cały ten rok moja mama ani razu nie płakała.	All through that one year my mother never cried one time not once.	W czasie tego roku mama ani razu nie płakała
Nie ma już spójności w sygnałach powierzchniowych.	There is no longer any consistency in the surface signals.	Nie ma już żadnej zgodności w sygnałach powierzchni.
To jest nasz superkomputer z tysiącem rdzeni.	This is our thousand core supercomputer.	To jest nasz tysiącprocesorowy superkomputer.
Na przykład w Mongolii, gdzie 30 procent ludzi to nomadyczne systemy informacyjne SMS, wykorzystywane są do śledzenia migracji i wzorców pogodowych.	In Mongolia for instance where 30 percent of the people are nomadic SMS information systems are being used to track migration and weather patterns.	użycie SMS ów ułatwia obserwację schematów migracji ludności której 30% prowadzi koczowniczy tryb życia jak również zmian pogodowych.
Dlatego zespół opracował nowe oprogramowanie do debugowania, w którym moglibyśmy przetestować każdy syntetyczny fragment, aby sprawdzić, czy będzie rosnąć na tle dzikiego DNA.	So the team developed new debugging software where we could test each synthetic fragment to see if it would grow in a background of wild type DNA.	W związku z tym stworzyliśmy debugger który badał każdy syntetyczny odcinek i sprawdzał czy wyrośnie w porównaniu do DNA typu dzikiego.
Taka jest rzeczywistość naszego współczesnego życia.	That is the reality of our modern life.	To część nowoczesnego życia.
Wszystkie żyją w koloniach składających się z jednej lub kilku królowych, a wszystkie mrówki, które widzisz, to bezpłodne pracownice.	They all live in colonies consisting of one or a few queens and then all the ants you see walking around are sterile female workers.	Żyją w koloniach w których jest jedna lub kilka królowych a wszystkie mrówki na powierzchni to bezpłodne robotnice.
Jedna trudność polega na tym, jak koordynować wiele tych robotów.	So one difficulty is how do you coordinate lots of these robots.	Jedną z trudności jest to jak skoordynować dużą liczbę robotów?
Lub, co ważniejsze, HIV, w przypadku którego wirus ewoluuje tak szybko, szczepionki, które są produkowane dzisiaj, nie nadążają za tymi ewolucyjnymi zmianami.	Or more importantly HIV where the virus evolves so quickly the vaccines that are made today can not keep up with those evolutionary changes.	Ważniejszy przykład to HIV który ewoluuje tak szybko że dzisiejsze szczepionki nie nadążają że dzisiejsze szczepionki nie nadążają za zmianami.
Dlatego Ham Smith i Clyde Hutchison opracowali kilka nowych metod wytwarzania wolnego od błędów DNA na niewielkim poziomie.	So Ham Smith and Clyde Hutchison developed some new methods for making error free DNA at a small level.	Ham Smith i Clyde Hutchinson opracowali nowe metody tworzenia małych odcinków DNA pozbawionych błędów. tworzenia małych odcinków DNA pozbawionych błędów.
Tak wcześnie opracowaliśmy koncepcję umieszczania znaków wodnych w DNA, aby absolutnie wyjaśnić, że DNA jest syntetyczne.	So early on we developed the notion of putting in watermarks in the DNA to absolutely make clear that the DNA was synthetic.	Dlatego od początku stosowaliśmy znaki wodne  Dlatego od początku stosowaliśmy znaki wodne  które odróżniają DNA syntetyczne od naturalnego. które odróżniają DNA syntetyczne od naturalnego.
Tak więc każdego roku tego samego dnia i jest tajemnicą, w jaki sposób dokładnie to się dzieje, każda kolonia wysyła swoje dziewicze, niesparowane królowe ze skrzydłami i samców, a wszystkie one lecą do wspólnego miejsca i łączą się w pary.	So every year on the same day and it is a mystery exactly how that happens each colony sends out its virgin unmated queens with wings and the males and they all fly to a common place And they mate.	Co roku tego samego dnia ale jak to działa? Każda kolonia wysyła skrzydlate królowe dziewice i samców lecą w jedno miejsce gdzie spółkują.
W rzeczywistości wiele z tych pojazdów jest obsługiwanych przez załogi lotnicze, które mogą obejmować wielu pilotów, operatorów czujników i koordynatorów misji.	In fact many of these vehicles are operated by flight crews that can include multiple pilots operators of sensors and mission coordinators.	Tak naprawdę wiele z nich jest sterowanych przez załogi w skład których wchodzi wielu pilotów operatorów czujników i koordynatorów misji.
Jak to się dzieje, że kolonii udaje się dostosować liczbę pracowników wykonujących każde zadanie w miarę zmieniających się warunków.	How is it that the colony manages to adjust the numbers of workers performing each task as conditions change.	W jaki sposób kolonia dostosowuje liczbę mrówek wykonujących jakąś pracę do zmieniających się warunków?
Teraz nie ma tajemnicy, w jaki sposób schudniesz, albo spalasz więcej kalorii poprzez ćwiczenia, albo jesz mniej.	Now there’s no mystery in how you lose weight you either burn more calories by exercise or you eat fewer calories.	To żadna tajemnica jak stracić wagę albo spalisz więcej kalorii przez ćwiczenia albo zjesz mniej kalorii.
Dlaczego dlaczego są na Bliskim Wschodzie?	Why Why are they in the Mid East.	Dlaczego?
Ale jest coś, co musisz zrobić. Nie wystarczy, żebym powiedział Pozwólmy na odważniejszą naukę w rolnictwie.	But there is something you must do It is not enough for me to say Let is get more bold science into agriculture.	Ale jest coś co Wy musicie zrobić. Nie wystarczy powiedzieć Wprowadźmy do rolnictwa więcej nauki.
Ponieważ my, lekarze, robimy to, za co nam płacą, i jesteśmy szkoleni, aby robić to, za co nam płacą, więc jeśli zmieniamy ubezpieczenie, zmieniamy praktykę medyczną i edukację medyczną.	Because we doctors do what we get paid to do and we get trained to do what we get paid to do so if we change insurance then we change medical practice and medical education.	Ponieważ my doktorzy robimy to za co nam płacą i trenują nas byśmy robili to za co nam płacą więc gdy zmienimy ubezpieczenie to zmienimy też edukację i praktykę medyczną.
Ubezpieczenie obejmie obejście, pokryje angioplastykę, a do niedawna nie obejmie diety i stylu życia.	Insurance will cover the bypass it’ll cover the angioplasty it won’t until recently cover diet and lifestyle.	Ubezpieczenie pokryje bypassy pokryje angioplastykę. Ale nie pokryje jak dotychczas diety i stylu życia.
Z drugiej strony wszystko, co sprzyja intymności, leczy.	Now on the other hand anything that promotes intimacy is healing.	Z drugiej strony wszystko co promuje intymność leczy.
Żeby wam to pokazać, to jest z CDC.	And just to show you this this is from the CDC.	By wam pokazać to jest z CDC.
Zabójczą aplikacją, która przygotowała świat na urządzenia AGD, była żarówka.	The killer app that got the world ready for appliances was the light bulb.	Hitem który przygotował Świat na urządzenia była żarówka.
Ilu z was rzeczywiście potrafi odróżnić pszenicę od innych zbóż.	How many of you can actually tell wheat apart from other cereals.	Ilu z Was potrafi odróżnić pszenicę od innych zbóż?
Więc co możemy zrobić.	So what can we do.	Co możemy zrobić?
Jeśli będą coraz mniej szczęśliwi, będzie to złe dla Amerykanów.	If they get less and less happy that will be bad for Americans.	Gdy są coraz mniej szczęśliwi to jest to złe dla Amerykanów. Ok.
Ale wiedzieliśmy jedno.	But we did know one thing.	Ale wiedzieliśmy jedno.
Chciał, aby główny bohater filmu był odgrywany od kołyski do grobu przez jednego aktora.	He wanted the main character of the film to be played from the cradle to the grave by one actor.	Chciał żeby głównego bohatera od początku do końca grał jeden aktor.
Aby spróbować odpowiedzieć na niektóre z tych pytań, ponownie zwracamy się do technologii do technologii biologicznej, w tym przypadku ponownie telemetria włącza radio na 10 gharialów i faktycznie śledzi ich ruchy Są obserwowani codziennie, gdy mówimy, aby spróbować dowiedzieć się, co to za tajemnicza toksyna jest.	In order to try to answer some of these questions we again turn to technology to biological technology in this case again telemetry putting radios on 10 gharial and actually following their movements They are being watched everyday as we speak to try to find out what this mysterious toxin is.	Żeby znaleźć odpowiedzi na niektóre pytania wykorzystujemy technikę w tym przypadku telemetrię. Założyliśmy odbiorniki radiowe dziesięciu gawialom i każdego dnia śledzimy ich ruchy próbując się dowiedzieć co to za tajemnicza toksyna.
A politycy mogą być świadomi i powinni być świadomi, że kiedy ludzie na całym świecie patrzą na nich, patrzą na swój naród i wychwytują wskazówki, czy są w relacji o sumie zerowej, czy niezerowej z narodem, takim jak Ameryka lub psychologia każdego innego narodu jest taka, że ​​używają wskazówek takich jak Czy czujemy, że jesteśmy szanowani.	And politicians can be aware and should be aware that when people around the world are looking at them are looking at their nation and picking up their cues for whether they are in a zero sum or a non zero sum relationship with a nation like say America or any other nation human psychology is such that they use cues like Do we feel we are being respected.	A politycy mogą i powinni być świadomi tego że kiedy ludzie z całego świata patrzą na nich na ich naród i rozpoznają wskazówki dotyczące tego czy pozostają oni w relacjach sumy zerowej czy niezerowej wobec narodu tak jak powiedzmy Ameryka lub jakikolwiek inny naród to ludzki umysł będzie stawiał sobie pytania takie jak Czy czujemy się szanowani?
Korporuje artystów, dzikie zwierzęta, a starzy, dobrzy ludzie mogą przywrócić te rzeki z powrotem.	The corporates the artists the wildlife nuts the good old everyday folks can actually bring these rivers back.	Inwestorzy artyści pasjonaci przyrody i zwykli ludzie mogą naprawić stan tych rzek.
Idź do zegara. To, co tu mamy, to coś, co wielu z was widziało tu trzy lata temu.	Go to the clock And what we have here is something many of you saw here three years ago.	Zajmijmy się zegarem. Wielu z was widziało go już trzy lata temu.
I oczywiście te przekraczają wiek, rasę, kulturę, płeć.	And of course these transcend age race culture gender.	Oczywiście nie chodzi tu o wiek kolor skóry kulturę czy płeć.
Postanowiliśmy więc obsadzić serię małych ludzi, którzy graliby w różne ciała Benjamina w różnych momentach jego życia i faktycznie stworzymy wygenerowaną komputerowo wersję Brada w wieku głowy, aby wyglądać jak Benjamin i dołączyć to do ciało prawdziwego aktora.	So we decided to cast a series of little people that would play the different bodies of Benjamin at the different increments of his life and that we would in fact create a computer generated version of Brad is head aged to appear as Benjamin and attach that to the body of the real actor.	Więc postanowiliśmy że różni niscy ludzie zagrają ciało Benjamina z poszczególnych etapów jego życia a my stworzymy komputerową wersję jego głowy odpowiednio postarzoną i połączymy ją z ciałem prawdziwego aktora.
Jak studiujesz góry pod kątem tego, o czym mówimy.	How do you study a mountain for the kinds of things we are talking about.	Jak przeanalizować górę na takie potrzeby?
IM Tak, to jest dokładnie.	IM Yeah it is exactly.	IM Tak taka jest dokładnie.
Wszystko się do tego sprowadza.	Everything boils down to that.	Wszystko sprowadza się do tego.
Wysiedliśmy więc, poszliśmy i na pewno około pół mili dotarliśmy do szczytu tego wzgórza i było tam ogromne zgromadzenie Beduinów z ich wielbłądami.	So we got out and walked and sure enough about half a mile we came over the crest of this hill and there was a huge gathering of Bedouin with their camels.	Okazało się że jakieś półtora kilometra stamtąd Okazało się że jakieś półtora kilometra stamtąd była grupa Beduinów z wielbłądami.
Jestem elegancko zaprojektowany.	I am smartly designed.	Mam wszytko co trzeba .
Chciałbym, żebyście wyobrazili sobie, że to jest tablica i właśnie tam użyłam kredy.	And I would like you to imagine that that is a blackboard and I just used some chalk on there.	Wyobraźcie sobie że to taka tablica. Wyobraźcie sobie że to taka tablica.
I były chwile, kiedy byłam tak zdesperowana, że ​​po prostu wiedziałaś, że wchodzisz do pokoju i po prostu idziesz jak Eric.	And there were times when I was actually so desperate I would just you know walk into a room and just go like Eric.	A były czasy kiedy byłem tak zdesperowany że po prostu wiecie wchodziłem do pokoju i wołałem Eric! .
Zresztą rzuć ten mały klip, który ci pokażę.	And anyway roll this little clip I will just show you.	No dobrze przewińcie ten klip po prostu wam pokażę.
Cóż, statystycznie większość osób przystępujących do organizacji ekstremistycznych ma wysokie wykształcenie.	Well statistically the majority of those who join extremist organizations are highly educated.	Cóż statystycznie – większość tych którzy przyłączają się do organizacji ekstremistycznych jest świetnie wykształcona.
A to dla nich prawdziwy kryzys.	And this is a real crisis for them.	To był kryzys.
Jedną z innych rzeczy na temat wielbłąda jest piękny design, to fakt, że jego penis jest skierowany do tyłu.	One of the other things about the camel is beautiful design is that its penis points backwards.	Co ciekawe ich penis skierowany jest do tyłu
Więc coś, o czym warto pomyśleć dzisiejszego wieczoru, jeśli miałeś parę.	So something to think about tonight if you have had a couple.	Materiał do przemyśleń dziś wieczorem jeśli wychylicie kilka głębszych.
Później usłyszałem, że ofiar w Iraku nie można leczyć w Taji.	I later heard that Iraqi casualties were not to be treated in Taji.	Później dowiedziałem się że ranni nie mogli zostać otoczeni opieką w Taji.
Dałem im około dziewięciu minut i gotowe.	Gave them about a nine minute response and there we went.	przez 9 minut opowiadałam no i ruszyliśmy.
Należy to naprawić, ponieważ jeśli nie możesz wprowadzić tych osób do formalnej siły roboczej, w końcu stworzysz całą masę osób, które są całkowicie pozbawione praw wyborczych.	This needs to be fixed because unless you can bring these people into the formal workforce you will end up creating a whole lot of people who are completely disenfranchised.	Trzeba to rozwiązać bowiem jeśli nie wciągnie się tych wszystkich ludzi z szarej strefy zostaniemy w sytuacji w której utworzymy całą masę ludzi upośledzonych społecznie.
Jedna to kwestia edukacji.	One is the question of education.	Pierwszą jest kwestia edukacji.
Przez większość roku zachowywałem się jak pączek z lukrem.	I was like a glazed doughnut for most of the year.	Wyglądałem jak pączek z lukrem przez większość roku.
MM Nie wrócę.	MM I will not go back.	M Nie wrócę tam.
Nie ma na nim lodu.	There is no ice over it.	Nie ma na nim lodu.
Straciłem wszelką wiarę w media, nieszczęsny żart, z którego wolałbym się śmiać, niż stać się jego częścią.	I have lost all faith in the media a hapless joke I would much rather laugh at than become a part of.	straciłem całą wiarę w media nieszczęsny dowcip z któego chciałbym się śmiać aniżeli występować w nim.
Ma to znaczenie, bo to jest demokracja.	It matters because this is a democracy.	Ma to znaczenie bo jest to demokracja.
Ponadto istnieją znaki, które naprawdę wolą zakończenie tekstów, takie jak ten znak w kształcie słoika, a ten znak w rzeczywistości jest najczęściej występującym znakiem w scenariuszu.	And furthermore there is some signs that really prefer the end of texts such as this jar shaped sign and this sign in fact happens to be the most frequently occurring sign in the script.	Ponadto istnieją znaki które najczęściej występują na końcu takie jak np. ten w kształcie słoja. Co więcej ten znak jest najczęściej występującym znakiem w tym piśmie.
Nigdy nie mam dość, nawet jeśli jestem miliarderem, nie mam dość.	I never have enough even if I am a billionaire I don not have enough.	Nigdy nie ma się dość będąc nawet miliarderem chce się zawsze więcej.
Kiedy to zrobiliśmy, oto nowy eksperyment, w którym umieściliśmy zwierzę i kazaliśmy mu uruchomić pająka trawiastego na powierzchni z usuniętym 99% obszaru kontaktu.	When we did that here is a new experiment that we did we put an animal and had it run this grass spider on a surface with 99 percent of the contact area removed.	Kiedy to zrobiliśmy przeprowadziliśmy nowy eksperyment wzięliśmy zwierzę i skłoniliśmy do biegania tego pająka po obszarze z usuniętymi 99% powierzchni kontaktowej.
Poczekaj, aż zobaczysz może w przyszłym roku jakie okna wymyśliliśmy.	Wait till you see maybe next year what kind of windows we have invented.	Poczekaj jeszcze rok to zobaczysz jakie okna my stworzyliśmy.
Dam ci kilka sekund.	I will give you a couple seconds.	Zastanówcie się kilka sekund.
Jeśli dam ci literę Q i poproszę o przewidzenie następnej litery, jak myślisz, co by to było.	If I give you the letter Q and ask you to predict the next letter what do you think that would be.	Jeśli podam wam literę Q i poproszę was o przewidzenie następnej litery co odpowiecie?
A potem jej powiem.	And then I am going to tell her.	I wtedy jej powiem.
W każdej chwili może przerwać operację.	He can stop the surgery at any moment.	Może w każdym momencie zatrzymać sonikację.
Utracono wszelką znajomość języka angielskiego i alfabetu angielskiego.	All knowledge of the English language and the English alphabet has been lost.	Cała wiedza na temat języka angielskiego i jego alfabetu została zapomniana.
OK, więc możesz zobaczyć tutaj miejsce.	Okay so you can see here the spot.	Widzimy tu ten oto punkt.
Myślę, że WorldWide Telescope przekona cię, że możemy być mali, ale jesteśmy naprawdę cudownie ważni.	I think the WorldWide Telescope will convince you that we may be tiny but we are truly wonderfully significant.	WorldWide Telescope przekona was że mimo naszych małych rozmiarów
Ona wywraca to na lewą stronę.	She is turning it inside out.	Ogląda ją z każdej strony.
To coś, co nazywa się podziemnym lasem.	This is something called an underground forest.	To tak zwany podziemny las.
Hairdos bez ochrony praw autorskich.	Hairdos no copyright protection.	Fryzury brak ochrony własności intelektualnej.
No i oczywiście porosty.	And then of course there is the lichens.	A teraz przejdźmy wreszcie do porostów.
Może to więc mieć negatywny wpływ na całą populację.	So it could have a negative impact on the whole population.	Więc to zagraża całej populacji.
Czy ty go dotknąłeś.	Did you touch it.	Wyczułeś je?
Na szczęście nadal wydaje się, że nie zaszkodziło to ostatniemu wyciekowi ropy.	Luckily still it seems to be out of harm is way of the recent oil spill.	Szczęśliwym trafem nie zaszkodził mu też niedawny wyciek ropy. Szczęśliwym trafem nie zaszkodził mu też niedawny wyciek ropy.
Jednak sukces kampanii zajął 24 lata.	But it took 24 years for the campaign to be successful.	Wygrali po 24 latach.
To klonalna kolonia drzew Quaking Aspen żyjących w Utah, która ma dosłownie 80000 lat.	This is clonal colony of Quaking Aspen trees living in Utah that is literally 80000 years old.	To kolonia klonalna osiki w Utah To kolonia klonalna osiki w Utah która ma 80 000 lat.
A potem, gdy dojdziesz do stacji, jest ona rozszerzona, abyś mógł ją przeczytać.	And then when you get to a station it is expanded so that you can actually read it.	Po wjechaniu na stację słowa rosną i stają się czytelne.
Mogą używać obu moich rąk. Mogę używać akcentów aktorskich. Mogę po prostu podnieść się i użyć wszystkich 10 palców, jeśli chcę.	They can use both my hands I can use chording actions I can just go right up and use all 10 fingers if I wanted to.	Mogę użyć obu moich rąk mogę użyć równoległych akcji lub użyć wszystkich 10 palców jeżeli tylko chcę.
Można zauważyć, że jest wrażliwy na nacisk.	It is pressure sensitive you can notice.	Jest wrażliwe jak widać na siłę nacisku.
Więc Chris mógłby być tutaj, wchodząc w interakcję z inną częścią lawy, podczas gdy ja trochę się tym bawię Możesz wyobrazić sobie nowy rodzaj narzędzia do rzeźbienia, w którym rozgrzewam coś, aby było plastyczne, a następnie pozwalałem mu ostygnąć i zestalić się pewien stan.	So Chris could be out here interacting with another part of Lava while I kind of play around with it here You can imagine a new kind of sculpting tool where I am kind of warming something up making it malleable and then letting it cool down and solidifying in a certain state.	Chris bawi się jedną częścią naszej lampy lawy A ja bawię się drugą. Wyobraźcie sobie nowy rodzaj dłuta rzeźbiarskiego. Podgrzewam coś zmieniając jego plastyczność a następnie pozwalam ostygnąć i zastygnąć w danym stanie.
Podsumowując, chciałbym tylko zaznaczyć, że wiesz, że wieloryby żyją w niesamowitym środowisku akustycznym.	So to conclude I would just like to point out you know the whales live in an amazing acoustic environment.	Na koniec chcę podkreślić że wieloryby żyją w niezwykłym środowisku akustycznym. że wieloryby żyją w niezwykłym środowisku akustycznym.
Te czarne linie wyznaczają szlaki żeglugowe w Zatoce Fundy i poza nią.	These black lines mark shipping lanes in and out of the Bay of Fundy.	Czarne linie to korytarze transportowe do i z zatoki.
Więc dane dotyczące rezygnacji są niesamowite.	So the data on dropping out is amazing.	Dane na temat rzucania szkoły są niesamowite.
Co ciekawe, kiedyś budowaliśmy głównie modele 3D, o których wiesz, że widzieliście niektóre z nich dzisiaj, i renderingi 3D.	Interestingly enough we used to primarily build 3 D models you know you have seen some today and 3 D renderings.	Co ciekawe kiedyś budowaliśmy głównie modele 3 D widzieliście dzisiaj kilka oraz makiety 3 D.
Palec palec różowy lub palec.	Finger finger finger pink or finger.	Palec palec palec palec różowa albo palec.
Mogę przełączać się do różnych widoków danych. To właśnie jest fajne w tej aplikacji.	I can switch to different data views That is what is neat about this app here.	Zmienię teraz na inny widok. To jest sprytne w tej aplikacji.
Zdigitalizowali miliony książek.	They have digitized millions of books.	Zcyfryzowali miliony książek.
To tylko właściwe, żebyś ty tutaj, na TED, najpierw to usłyszał i zobaczył.	It is only proper that you here at TED hear and see it first.	Możecie jednak to już teraz zobaczyć i usłyszeć dzięki TED .
Jean Baptiste Michel Jak więc doszliśmy do tego wniosku.	Jean Baptiste Michel So how did we get to this conclusion.	Jean Baptiste Michel Więc jak doszliśmy do tego wniosku?
Ale widziałem, jak poziom moralny może wznieść się od jednej osoby, to działanie.	But I saw how the level of moral standard can rise from one person is action.	Przekonałam się że moralne standardy może podnieść postawa jednego człowieka.
Wszyscy jesteście teraz inteligentni, ale nic nie robicie.	You are all being intelligent right now but you are not doing anything.	Wszyscy jesteście już inteligentni nawet nie robiąc nic w tej chwili.
Cóż, rozsądne oczekiwanie jest takie, że ktoś jest sławny w danym okresie, powinien być mniej więcej średnią jego sławy przed i po.	Well a reasonable expectation is that somebody is fame in a given period of time should be roughly the average of their fame before and their fame after.	Racjonalnym oczekiwaniem jest to że czyjaś sława w określonym okresie czasu powinna być średnią jego sławy przed i po.
Idę, jeśli mogę mieć tutaj mój pierwszy slajd, a zobaczysz tytuł mojego wystąpienia i moje dwie afiliacje.	I am going to if I can have my first slide up here and you will see the title of my talk and my two affiliations.	Jeśli mogę prosić o mój pierwszy slajd zobaczycie tytuł mojej prezentacji i moje dwa powiązania.
Musimy to udostępnić ludziom.	We have to make this available for people.	Musimy to udostępnić ludziom.
I to jest prawdziwy wstyd. Dlaczego tak się stało?	And it is a real shame Now why has this come about.	To naprawdę wielki wstyd. Więc dlaczego tak się dzieje?
Różnicowanie to kolejna technika, której używamy.	Differencing is another technique we use.	Różnicowanie jest kolejną techniką której używamy.
Jestem naprawdę podekscytowany. To wcale nie zajmie 50 lat.	I am really really excited This is not going to take 50 years at all.	To takie ekscytujące. Stworzenie teorii mózgu nie zajmie nam wcale 50 lat.
Wydobywasz książki z maszyn, dzieci to książki.	You get books out of the machines children is books.	Wyciągałeś z niej książki takie dla dzieci.
Dziewięćdziesiąt pięć procent naszych profesorów twierdzi, że są ponadprzeciętnymi nauczycielami.	Ninety five percent of our professors report that they are above average teachers.	95% profesorów uważa się za ponadprzeciętnego nauczyciela.
A więc doprowadziło to do płytkiej ścieżki w polityce, ale także w całym szeregu ludzkich przedsięwzięć.	And so this has led to a shallow path in politics but also in a whole range of human endeavors.	To zatem doprowadziło do płytkiej ścieżki w polityce ale także w szeregu innych ludzkich przedsięwzięć.
Mairead McGuire w środku Betty Williams po prawej stronie niosąc pokój w Irlandii Północnej.	Mairead McGuire in the middle Betty Williams on the right hand side bringing peace to Northern Ireland.	Mairead McGuire w centrum Betty Williams po prawej stronie przynosząc pokój Irlandii Północnej.
Jeśli zawieje je wiatr, są jak chrząszcze uwięzione na ziemi.	If the wind blows them over they are like beetles stuck there on the ground.	Jak wiatr je przewróci są jak żuki przykute do ziemi.
W rzeczywistości wyolbrzymia ich odrębność reprezentacji w wielowymiarowych neuronalnych terminach reprezentacji.	It actually exaggerates their separateness of representation in multi dimensional neuronal representational terms.	Podkreśla on wyodrębnienie wyobrażenia tego dźwięku w kontekście wielowymiarowych wyobrażeń neuronalnych.
I to jest okres, w którym mózg ustawia w swojej pierwotnej formie swoją podstawową maszynerię przetwarzania.	And that is the period in which the brain is setting up in its initial form its basic processing machinery.	W którym to mózg organizuje swoja pierwotną formę podstawową maszynerię.
To, co widzisz, to znaczna poprawa ich natychmiastowej pamięci o ich zdolności do zapamiętywania rzeczy po opóźnieniu ich zdolności kontrolowania ich uwagi, ich zdolności językowych i wizualnych zdolności przestrzennych.	And what you see are substantial improvements of their immediate memory of their ability to remember things after a delay of their ability to control their attention their language abilities and visual spatial abilities.	Widzimy znaczącą poprawę ich pamięci umiejętności przywoływania faktów poprawę w kierowaniu swoją uwagą zdolności językowych i przestrzennych.
Odwożą ich do domu i chcą, aby zostali oświeceni, więc zabierają ich do Ben & amp Jerry to firma produkująca lody z własną polityką zagraniczną.	Driving them home and they want them to be enlightened so they take them to Ben &amp Jerry is ice cream company with its own foreign policy.	Wiozą je do domu a że chcą by dzieci były odpowiednio oświecone zabierają je do sklepu Ben &amp Jerry s firmy lodziarskiej z własną polityką zagraniczną.
Powiedział, że my, południowcy, lubimy gładką powierzchnię, więc były chwile, kiedy po prostu nie chciał konfrontacji.	He said We southerners do like a smooth surface so that there were times when he just didn not want the confrontation.	Powiedział „My południowcy naprawdę lubimy gładką powierzchnię więc musiały być sytuacje kiedy po prostu nie chciał konfrontacji.”.
Więc ona i ja odbyliśmy wspaniałą rozmowę.	So she and I had a delightful conversation.	Więc ona i ja rozpoczęliśmy przemiłą konwersację.
Pomyślałem, że to będzie bułka z masłem, ponieważ zawsze prowadzę wstępne rozmowy z tymi ludźmi przez może 10 lub 15 minut.	And I thought this is going to be a piece of cake because I always have preliminary talks with these people for just maybe 10 or 15 minutes.	Wydawało mi się że to będzie banalnie proste ponieważ zawsze przeprowadzam wstępną pogawędkę z tymi osobami tylko jakieś 10 może 15 minut.
Miałem tę firmę, którą spędziłbym 15 lat budując. Nazywa się Future, była to firma wydawnicza.	I had this company that I would spent 15 years building It is called Future it was a magazine publishing company.	Miałem firmę którą budowałem przez 15 lat – o nazwie Future Przyszłość. Wydawnictwo czasopism.
Więc to jedna z historii ropy naftowej, jest jej po prostu dużo.	So that is one of the stories of oil there is just a lot of it.	Reasumując informacje o ropie jest jej bardzo dużo.
Brak zarządzania w wielu obszarach w obszarze korupcji i niszczenia środowiska w obszarze wykorzystywania kobiet i dzieci w obszarze zmian klimatycznych we wszystkich obszarach, w których naprawdę potrzebujemy zdolności do przywrócenia prymatu polityki w gospodarkę działającą na arenie światowej.	Failing governance in many areas in the area of corruption and the area of destruction of the environment in the area of exploitation of women and children in the area of climate change in all the areas in which we really need a capacity to reintroduce the primacy of politics into the economy which is operating in a worldwide arena.	Zawodzą w różnych dziedzinach w dziedzinie przeciwdziałania korupcji i ochrony środowiska w przeciwdziałaniu przemocy i wykorzystywaniu dzieci i kobiet w dziedzinie zmian klimatu. We wszystkich tych dziedzinach w których potrzebujemy władzy by przywrócić wiodącą rolę polityki dla gospodarki która działa na światowej arenie.
Tak, jest bardzo różny, nie, nie jest inny.	Yeah it is very different no it is not different.	Tak różnią się znacznie od siebie ale czy aż tak bardzo?
Pracowałem jako dyrektor biura Banku Światowego w Nairobi w Afryce Wschodniej.	I used to work as the director of the World Bank office in Nairobi for East Africa.	Kiedyś byłem dyrektorem biura Banku Światowego w Nairobi dla Afryki Wschodniej.
A co gorsza, znacznie gorsze niż to, że moje poczucie własnej wartości w pewnym sensie wyparowało.	And worse than that far worse than that my sense of self worth was kind of evaporating.	Co gorsze o wiele gorsze traciłem też poczucie własnej wartości.
Jedna z historii, które opowiadał mi tak często, kiedy byłem małym chłopcem, dotyczyła pierwszego brytyjskiego testu bomby atomowej.	And one of the stories he told me so often when I was a young boy was of the first British atomic bomb test.	Jedną z opowieści których słuchałem jako młody chłopiec była ta o pierwszym brytyjskim teście bomby atomowej.
Po lewej stronie zobaczysz przetworzone wideo, w którym kamera uczyniła go niewidzialnym.	And on the left side you will see the processed video where the camera has made him invisible.	A po lewej przetworzony obraz w którym dzięki kamerze staje się niewidzialny.
Więc zacząłem robić te zabawne rzeczy.	And so I started making these funny things.	I tak zacząłem tworzyć te śmieszne rzeczy.
Rzecz po prawej stronie to wąż z zigguratu.	The thing on the right is a snake form a ziggurat.	To po prawej stronie to forma węża ziggurat.
Właściwie to w zasadzie trzy kwadratowe pokoje z kilkoma świetlikami i innymi rzeczami.	It is actually basically three square rooms with a couple of skylights and stuff.	Składają się na nie praktycznie 3 pomieszczenia z paroma świetlikami itp.
Herman Miller wyznaje tę filozofię, że miejsce jest miejscem dla ludzi.	And Herman Miller has this philosophy of having a place a people place.	A Herman Miller posiada filozofię na temat miejsca miejsca dla ludzi.
A budynek jest bardzo rzeźbiarski, gdy go obchodzisz.	And the building is very sculptural as you walk around it.	Budynek wygląda jak rzeźba gdy się go ogląda obchodząc wokół.
Chodzi mi o to, że to trochę banalna rzecz, ale to prawda, że ​​chcieli mieć centralne miejsce, w którym byłaby stołówka, gdzie przychodziliby ludzie i gdzie ludzie pracujący wchodziliby w interakcję.	I mean it is kind of a trite thing to say but it is real that they wanted to have a central place where the cafeteria would be where the people would come and where the people working would interact.	To banalne co powiem ale rzeczywiście chcieli mieć centralne miejsce gdzie mogłaby być stołówka w której spotykaliby się ludzie by nawiązywać wzajemne kontakty.
A po tym, jak zawiedliśmy, po prostu zawodziłem.	And after we failed I just kept failing.	I gdy nam się nie udało dalej odnoszę porażki.
Teraz, gdybyście zobaczyli zdjęcie tego, które zostało opublikowane w Architectural Record, nie pokazały one kontekstu, więc można by pomyśleć, Boże, co to za nachalny facet.	Now if you saw a picture of this as it was published in Architectural Record they didn not show the context so you would think God what a pushy guy this is.	Zobaczywszy to zdjęcie opublikowane w Architectural Record bez pokazania kontekstu można pomyśleć Boże! Co za bezczelny typ! .
Kiedy ludzie robią zdjęcia tym budynkom z tego kontekstu, wyglądają naprawdę dziwnie i zakładam, że mają one dużo więcej sensu, gdy są fotografowane lub widziane w tej przestrzeni.	When people take pictures of these buildings out of that context they look really weird and my premise is that they make a lot more sense when they are photographed or seen in that space.	Na zdjęciach tych budynków bez ujęcia kontekstu w jakim się znajdują wyglądają rzeczywiście dziwnie. Natomiast według mnie te budowle mają wiele sensu jeśli fotografowane lub oglądane są w kontekście ich otoczenia.
Ponadto dochód generowany z tego węgla drzewnego wynosi 260 milionów dolarów.	In addition the revenue generated from that charcoal is 260 million dollars.	Ponadto przychód jaki można wygenerować z naszego węgla wyniesie 260 milionów dolarów.
Nie możesz więc używać tych samych modeli, których używasz w Stanach Zjednoczonych, aby przyspieszyć rozwój.	So you can not use the same models that you use in the United States for making things move forward.	Nie można więc użyć tych samych schematów działania co w Stanach Zjednoczonych aby wszystko ruszyło do przodu.
A to oczywiście ostrzega dziecko o ich niezwykłej naturze.	And that obviously alerts the child to their unusual nature.	I ta ciekawość wyraźnie alarmuje dziecko o jego niecodziennej naturze.
Dysmorfofobia to skrajna wersja tego, że nie postrzegamy siebie tak, jak widzą nas inni.	Dysmorphophobia is an extreme version of the fact that we don not see ourselves as others see us.	Dysmorfofobia to skrajny przypadek sytuacji w której nie postrzegamy siebie tak jak widzą nas inni.
Szybki moment dla projektantów na widowni.	Quick moment for the designers in the audience.	Chwila dla projektantów wśród publiczności.
Nazywa się je bateriami jądrowymi.	They are referred to as nuclear batteries.	Mówi się o nich jako jądrowych bateriach.
Nasza siedziba znajduje się na Florydzie.	We are based down in Florida.	Jesteśmy na Florydzie.
To dobra wiadomość.	That is the good news.	To dobra wiadomość.
Ale inni dorośli mówią niezwykle bolesne rzeczy.	But other adults say incredibly painful things.	Ale inni dorośli wypowiadają niezwykle bolesne uwagi.
Jesteśmy u progu największego odkrycia, jakie kiedykolwiek znała ludzkość.	We are on the verge of the greatest exploration that the human race has ever known.	Jesteśmy na skraju największej wyprawy w historii rasy ludzkiej.
I mówi: Wydaje się, że idealnym argumentem dla większości filozofów jest to, że dajesz słuchaczom przesłanki, a następnie dajesz im wnioski i wnioski, a jeśli nie zaakceptują wniosku, umrą.	And he says It seems as if the ideal argument for most philosophers is you give your audience the premises and then you give them the inferences and the conclusion and if they don not accept the conclusion they die.	Dla większości filozofów idealna argumentacja polega na przedstawieniu słuchaczom założeń a następnie przekazaniu im wnioskowania i konkluzji. Jeżeli nie zgodzą się z wnioskami muszą zginąć!
I sprawił, że igła wyglądała, jakby Hulk ją złamał.	And made a needle look like the Hulk is broken it.	tak aby wydawało się że to Hulk ją złamał.
Przypomina mu to słowo pudel barokowy barokowy Suzanne R, który wyrusza na wyścigi.	That reminds him of the word baroque barrack bark poodle Suzanne R he is off to the races.	co kojarzy mu się ze słowem barok buda szczekać pudelek Suzanne R. rozpędza się.
Myślisz, że szczegół jest obecny, ale go nie ma.	You think the detail is there but it isn not there.	Myślisz że szczegół jest ale go tam nie ma.
Zacząłem więc swoje życie jako architekt lub jako architekt i zawsze byłem zainteresowany społecznie odpowiedzialnym projektowaniem i tym, jak naprawdę można wywrzeć wpływ.	So I started my life as an architect or training as an architect and I was always interested in socially responsible design and how you can really make an impact.	Swoje życie rozpocząłem jako architekt właściwie szkoląc się na architekta i zawsze interesowały mnie odpowiedzialne społecznie projekty oraz to jak zrobić coś naprawdę ważnego.
