I zacznę od tego, jeśli mama nie jest szczęśliwa, to nikt nie jest szczęśliwy.	And I am going to start with this one If momma ain not happy ain not nobody happy.	Rozpocznę od tego. Gdy mama jest smutna wszyscy się smucą.
Te wibracje, te bakterie mogą w rzeczywistości zarażać ludzi.	These vibrios these bacteria can actually infect people.	Przecinkowce te bakterie są niebezpieczne dla ludzi.
To gra styropianowo-czekoladowa.	It is the Styrofoam and chocolate game.	To gra w styropian i czekoladę.
Ma uszy, które poruszają się biernie, gdy głowa idzie.	It has ears that move passively when the head goes.	Ma uszy które biernie się poruszają gdy porusza się głowa.
Mówił o tym, jak mandale starożytnej religii hinduistycznej były wyrzucane w niebo jako próba odzyskania poczucia porządku po chaosie wojny.	He talked about how the mandalas of ancient Hindu religion were kind of projected into the sky as an attempt to regain some sense of order after the chaos of war.	Opisywał jak mandale w starożytnym hinduizmie były jakby kreślone na niebie przez ludzi jako próba odzyskania jakiegoś poczucia porządku po chaosie wojny.
Mamy więc również tę zdolność.	So we have this ability as well.	Też mamy taką zdolność.
Kładą się spać około 20:00 do północy, a następnie ponownie śpią od około 2:00 do wschodu słońca.	They go to bed around 8 00 pm until midnight and then again they sleep from about 2 00 am until sunrise.	Idą spać koło 20 i śpią do północy potem śpią znowu od 2 do wschodu słońca.
YB A więc energia wiatrowa, energia słoneczna, o której mieliśmy dużo do omówienia.	YB So wind power solar power we had a lot to talk about.	YB Energia wiatru energia słoneczna mieliśmy wiele rzeczy do obgadania.
Te zakwity generują inne rodzaje chemikaliów.	Those blooms are generating other kinds of chemicals.	Zakwity tworzą inne rodzaje związków chemicznych.
W Port Elizabeth wioska na obrzeżach Port Elizabeth w RPA.	In Port Elizabeth the village outside Port Elizabeth in South Africa.	W Port Elizabeth wiosce nieopodal Port Elizabeth w południowej Afryce.
W krajach rozwijających się powiedziała, że ​​mają dwa miliardy ludzi.	In the developing world she said they had two billion people.	W rozwijającym się świecie powiedziała były dwa miliardy ludzi.
To znaczy od 1985 do 2003 roku.	That is from 1985 to 2003.	To wyniki od 1985 do 2003.
Nie ma nic poza wojną nuklearną, jakiej nigdy nie widzieliśmy, a która może powstrzymać ten wzrost.	There is nothing but a nuclear war of a kind we have never seen that can stop this growth from happening.	Nic oprócz wojny nuklearnej na niespotykaną skalę tego nie powstrzyma.
Spodziewali się, że będą to młode rodziny lub młodzi mężczyźni, tak jak zawsze.	And they expected that it would be young families or young men just like it had always been.	Zakładali że głównymi kupcami byłyby młode rodziny lub młodzi mężczyźni jak to zawsze bywało.
Z przodu widać Joe Murraya przygotowującego pacjenta do przeszczepu, podczas gdy na zapleczu widać, jak Hartwell Harrison, szef urologii Harvardu, pobiera właśnie nerkę.	In the front you see actually Joe Murray getting the patient ready for the transplant while in the back room you see Hartwell Harrison the Chief of Urology at Harvard actually harvesting the kidney.	Na pierwszym planie znajduje się Joe Muray przygotowujący pacjenta do zabiegu podczas gdy z tyłu Hartwell Harrison ordynator urologii na Harvardzie pobiera nerkę.
To się więcej nie powtórzy.	This will not happen again.	To się nie wydarzy.
To rozwiązuje jeszcze jedno założenie, że dawca i organizacja są w centrum, w przeciwieństwie do stawiania problemu w centrum.	This tackles yet another assumption that the giver and the organization is at the center as opposed to putting the problem at the center.	Te kategorie rozprawiają się z jeszcze jednym założeniem że dawca i organizacja są w centrum w przeciwieństwie do stawiania problemu w centrum.
Tak więc w sferze gospodarczej od dawna żyjemy z terminem szklany sufit.	So for a long time in the economic sphere we have lived with the term glass ceiling.	Bardzo długo w sferze ekonomii posługiwaliśmy się pojęciem szklanego sufitu.
Niektórzy mówią, że dzieje się tak dlatego, że w dziewiątej klasie chłopcy zaczynają porzucać szkołę.	And some people say it is because in 9th grade boys start dropping out of school.	Niektórzy mówią że to dlatego że w 9. klasie chłopcy zaczynają rzucać szkołę.
A jeśli kobiety nie urodziły dzieci płci męskiej, traktowano je w zasadzie jak pomoc domową.	And if women failed to birth male children they were basically treated like domestic servants.	I jeśli kobiecie nie udało się urodzić męskiego potomka w zasadzie była traktowana na równi ze służącymi.
Najmłodszy republikanin, ok, skończyliśmy.	Youngest Republican okay we are finished.	najmłodszy Republikanin gotowe.
I po trzecie, musimy szanować twórcę, twórcę tych remiksów, poprzez prawa, które są z nim bezpośrednio związane.	And number three We need to respect the creator the creator of these remixes through rights that are directly tied to them.	I po trzecie musimy szanować twórcę twórcę tych remiksów poprzez prawa które bezpośrednio im przysługują.
Ale jak każdy z nas miał pewne problemy.	But like all of us he had some problems.	Ale tak jak i my miał swoje problemy.
Ta osoba zaoferowała mi trzy grosze, a ja dostałem do trzech i pół.	This one person offered me three cents and I got him up to three and a half.	Ktoś oferował 3 centy a ja wytargowałem 35.
Chodzą dookoła, szukając tego, co to jest.	They go around looking for what it is.	Idą zobaczyć co to jest.
Szybka ścieżka Rozgrywamy grę.	We fast track We figure out the game.	Jadą pasem szybkiego ruchu. Rozgryzają zasady.
W wieku 10 lat byłem zmuszony do wyznaczenia trasy papierowej.	I was forced to get a paper route at 10 years old.	Musiałem rozwozić gazety w wieku 10 lat.
Sprzymierza się w naprawdę pozytywnym i opłacalnym ekonomicznie systemie żywnościowym.	It allies in a really positive and economically viable food system.	Ten sojusz jest bardzo pozytywny i ekonomicznie opłacalny dla systemu żywności.
A potem wiesz, co robimy Negocjujemy.	And then you know what we do We negotiate.	Wiecie co potem robimy? Negocjujemy.
Połączyła doświadczenie zawodowe i szkolenie z umiejętnościami życiowymi, których potrzebowały, takimi jak zarządzanie złością i pracą zespołową, a także jak rozmawiać z przyszłymi pracodawcami o tym, jak ich doświadczenia faktycznie pokazały lekcje, których się nauczyli, i ich chęć uczenia się więcej.	She combined employment experience and training with life skills they needed like anger management and teamwork and also how to talk to future employers about how their experiences actually demonstrated the lessons that they had learned and their eagerness to learn more.	Połączyła doświadczenie zawodowe i szkolenie umiejętności jakich potrzebowali jak opanowanie i praca zespołowa a także jak rozmawiać z przyszłymi pracodawcami o ich doświadczeniu rzeczywistość pokazała czego się nauczyli i jak bardzo chcą wiedzieć więcej.
I to było to, że internet kocha Mister Splashy Pants.	And that was that the Internet loves Mister Splashy Pants.	Internet uwielbia Pluszczka.
Na te systemy również oczekuje się patent, który jest w posiadaniu społeczności.	And there is a patent pending on these systems as well that is held by the community.	Czekamy na przyznanie patentu dla systemów stworzonych przez społeczność.
Naprawdę wierzą we własną wyższość i nie okazują szacunku tym, którzy nią nie są.	They really believe in their own superiority and they are disrespectful of those who are not.	Są głęboko przekonani o swojej wyższości i lekceważą inne nacje.
Ale to było naprawdę dla nas bardzo ważne jako strategia.	But it was really to us very important as a strategy.	Ale dla nas był to naprawdę istotny element strategii.
Dwa lata później mamy teraz farmy okienne, które są pionowymi platformami hydroponicznymi do uprawy żywności w pomieszczeniach.	Fast forward two years later we now have window farms which are vertical hydroponic platforms for food growing indoors.	Przejdźmy 2 lata do przodu. Mamy uprawy okienne które są pionowymi hydroponicznymi platformami do hodowli roślin w domach.
Powiedzieliśmy, że będzie to tylko krótki okres, do 26. Przedłużyliśmy go do 31.	We said it would be just for a short period until the 26 We have extended it until the 31.	Miał trwać tylko do 26 ale przedłużyliśmy go do końca miesiąca.
Voice Kismet, czy lubisz tę zabawkę?	Voice Kismet do you like the toy Oh.	Głos Kismet lubisz zabawkę? Oh.
W dniu premiery opublikowali 12-stronicowy dodatek w Wall Street Journal.	They had a 12 page supplement in the Wall Street Journal the day it launched.	W dniu premiery w Wall Street Journal ukazał się 12 stronicowy dodatek o tym.
Nie pracujemy w zakresie bibliotek, systemów katalogów i tak dalej.	We don not work in terms of libraries and catalog systems and so forth.	Nie działamy na zasadach biblioteki systemu katalogowania i tym podobnych.
I to jest bardzo ważne dla interfejsu użytkownika.	And that is very important the user interface.	co jest bardzo ważne. To interfejs użytkownika.
I pomyślałem, że najlepszym sposobem, jak większość z was wie, kto ma dzieci, jest posiadanie dziecka.	And I thought the best way as most of you know who have children the best way to have a new lease on life is to have a child.	I pomyślałem że najlepszym sposobem co większość z was posiadających dzieci wie najlepszym sposobem na to by odzyskać radość życia po trudnych przejściach jest mieć dziecko.
To my w Nowym Jorku.	That is us in New York.	To my w Nowym Jorku.
Naprawdę ważną kwestią dla mnie jest to, że nie korzystam z żadnej marki ani sponsorów korporacyjnych.	A really important point for me is that I don not use any brand or corporate sponsors.	Bardzo ważne jest dla mnie to że nie wspieramy się żadną marką czy wielkim sponsorem.
Zrobiłem tylko kilka zdjęć dzieciom, a następnego dnia przyszedłem z plakatami i wkleiliśmy je.	I just took a few photos of the kids and the next day I came with the posters and we pasted them.	Zrobiłem kilka fotografii dziecięcych i następnego dnia rozklejałem już plakaty z nimi.
Nie, byli naprawdę wielkimi maniakami i niewiele wiedzieli o sztuce.	No they were really big geeks and they didn not know much about art.	Nie naprawdę byli takimi świrami i nie znali się za bardzo na sztuce.
Rozumiemy, że staną się one znacznie bardziej zjadliwe, że to, co widzimy dzisiaj, to przeplatanie się społeczeństw systemów połączonych technologiami i przyspieszonych przez systemy zarządzania czasem.	We understand that these will become much more virulent that what we see today is this interweaving of societies of systems fastened by technologies and hastened by just in time management systems.	Wiemy że problemy zaostrzają się. Już dziś widzimy powiązania społeczeństw systemów napędzane systemami zarządzania just in time.
Amerykańska edukacja jest bardzo droga.	American education is so expensive.	Zdobycie wykształcenia w Ameryce jest takie kosztowne.
Wiesz, że normalnie pracujesz w izolacji i pokazujesz w galerii, ale tutaj praca ożywała i pracowali ze mną inni artyści.	You know normally you work in isolation and you show at a gallery but here the work was coming alive and it had some other artists working with me.	Jak wiecie normalnie pracuje się w odosobnieniu po czym pokazuje się to w galerii ale w tym przypadku prace ożywały i pracowali ze mną nad nimi inni artyści.
Chodzi o to, jak sprawić, by to się powtarzało i skalować.	It is just how do we make that recurrent and scale it.	Chodzi o to jak to powtórzyć i przenieść?
Liczba ta w Stanach Zjednoczonych i Europie Zachodniej wynosi osiem procent.	The number across the US and Western Europe is eight percent.	A w rzeczywistości w Stanach i Europie Zachodniej to jedynie 8 procent.
Zatem religie są kulturami powtarzania się.	So religions are cultures of repetition.	Religie polegają więc na powtarzaniu.
To jest instruktor, którego Alicia i ja wybraliśmy na męską rolę.	This is the instructor that Alicia and I chose for the male lead.	Tego instruktora wybraliśmy z Alicią na prowadzącego.
Jednym z nich była duża liczba znudzonych nastolatków, którzy po prostu nie lubili szkoły, nie mogli dostrzec związku między tym, czego nauczyli się w szkole, a przyszłymi zawodami.	One was large numbers of bored teenagers who just didn not like school couldn not see any relationship between what they learned in school and future jobs.	Pierwszy to tłum znudzonych nastolatków którzy nie lubili szkoły nie widzieli związku między programem nauczania a przyszłą pracą.
Więc zamiast tego chcesz się skupić, to pozwolić dolnej części ciała przeciągnąć się za górną część ciała, podobnie jak mały samochód za dużym samochodem na autostradzie.	So what you want to focus on instead is allowing your lower body to draft behind your upper body much like a small car behind a big car on the highway.	Zamiast tego należy się skupić na holowaniu nóg za tułowiem jak mały samochód za dużym na autostradzie.
Jest to więc trudny wybór.	So that is a sort of tough choice.	To raczej trudny wybór.
Chciałbym zacząć od spojrzenia na edukację.	I would like to kick off by looking at education.	Najpierw edukacja
Czasami pokazuje ci, czego nie powinieneś robić.	Sometimes it shows you what you shouldn not do.	Czasem pokazuje czego unikać.
To ostatnia rzecz, jaką zrobiła podczas ostatniego aktu fizycznego.	It is the last thing she did the last physical act.	To ostatnia rzecz jaką zrobiła ostatni fizyczny akt.
Podejmując swoją karierę projektanta, zacząłem zadawać sobie proste pytanie: czy naprawdę myślimy o pięknie, czy też je czujemy.	And as I took on my career as a designer I began to ask myself the simple question Do we actually think beauty or do we feel it.	Kiedy zaczynałem swoją karierę projektanta zadałem sobie proste pytanie czy piękno to coś o czym myślimy czy może coś co odczuwamy?
Najpierw dostałem instruktorkę, która nauczyła mnie roli kobiecej, ponieważ chciałem zrozumieć wrażliwość i umiejętności, które muszą rozwinąć następcy, aby nie mieć powtórki z college'u.	I got a female instructor first to teach me the female role the follow because I wanted to understand the sensitivities and abilities that the follow needed to develop so I wouldn not have a repeat of college.	Najpierw instruktorka uczyła mnie roli partnerki. Chciałem to zrozumieć żeby nie powtórzył się wypadek z uniwerku.
Jak mamy iść i mieć świat, w którym oboje mamy biblioteki i publikujemy w przyszłości, tak jak w zasadzie odnosiliśmy korzyści, gdy dorastaliśmy.	How do we go and have a world where we both have libraries and publishing in the future just as we basically benefited as we were growing up.	Jak sprawić by w świecie przyszłości istniały zarówno biblioteki jak i wydawnictwa czym mogliśmy się cieszyć w czasach naszej młodości?
Mamy teraz jedną z tych rzeczy. Jest całkiem fajna.	We have one of these things now It is completely cool.	Mamy jedną z nich jest naprawdę świetna.
Czy zauważyłeś, że Wikipedia jest używana przez nauczycieli i jak widzisz, że Wikipedia zmienia edukację?	Have you found Wikipedia being used by teachers and how do you see Wikipedia changing education.	Czy słyszałeś o wykorzystywaniu Wikipedii przez nauczycieli i jak wg ciebie Wikipedia zmienia edukację?
Chcę, żebyście sobie wyobrazili, że to waży dwie tony.	What I want you to imagine is this is two tons in weight.	Chcę żebyście wyobrazili sobie ten ciężar o wielkości 2 ton.
Chcę zakończyć.	I want to conclude.	Podsumowując
Kosztuje około 10 dolarów za sztukę, zabranie dysku i umieszczenie go w Internecie, jeśli robisz rzeczy w dużych ilościach.	It costs about 10 dollars a piece to go and take a disk and put it online if you are doing things in volume.	Za około 10 dolarów za sztukę można wziąć płytę i umieścić ją w sieci jeśli robi się to hurtowo.
Mogę wam powiedzieć na pewno, że następny, który planują, nazywa się Ekstremalnie Duży Teleskop.	I can tell you for a fact that the next one that they are planning is called The Extremely Large Telescope.	Faktem jest to że następny który planują nazwą Ekstremalnie Dużym Teleskopem.
Tak więc moja strona znajduje się na listach obserwacyjnych wielu wolontariuszy, ponieważ czasami jest niszczona.	So my page is on quite a few volunteers' watch lists because it is sometimes vandalized.	Moja strona jest na listach monitorowania sporej liczby użytkowników ponieważ czasem pada ofiarą wandalizmu.
Więc pomysł tej technologii może w rzeczywistości skończyć się oddawaniem książek ludziom w ręce.	So the idea of this technology actually may end up putting books back in people is hands again.	Więc taka technologia może faktycznie sprawić że ludzie dostaną więcej papierowych książek.
Całkowity miesięczny koszt naszej przepustowości to około 5000 dolarów.	And the total monthly cost for our bandwidth is about 5000 dollars.	Nasz całkowity miesięczny koszt połączeń internetowych to około 5000 dolarów.
Wrzucają do oceanu ogromne ilości zanieczyszczeń.	They pour huge amounts of pollutants into the ocean.	Wydzielają do oceanu wiele zanieczyszczeń.
Czy Amazon to nosi.	Does Amazon carry it.	Czy jest to w ofercie Amazon?
I każdej wiosny i jesieni dokładnie w czasie równonocy słońce wschodzi za jego świątynią i doskonale kąpie jej świątynię swoim cieniem.	And every spring and autumn exactly at the equinox the sun rises behind his temple and perfectly bathes her temple with his shadow.	Każdej wiosny i jesieni w czasie równonocy słońce wschodzi za jego świątynią i doskonale pokrywa swoim cieniem jej świątynię.
Nie możesz przestać myśleć o innym człowieku.	You can not stop thinking about another human being.	Nie można przestać myśleć o drugiej osobie.
Staraliśmy się zapobiec przedostawaniu się węgla do atmosfery.	We were trying to stop carbon from going into the atmosphere.	Nie chcieliśmy by przenikał do atmosfery.
Jeśli chodzi o naszą atmosferę, to jednak na dłuższą metę nie był to taki żart, ponieważ okazało się, że tracimy sporo tlenu.	When it came to our atmosphere however it wasn not that much of a joke over the long term because it turned out that we were losing oxygen quite a lot of oxygen.	Jednak kwestia atmosfery nie jest już taka zabawna ponieważ w końcu okazało się że tracimy dużo tlenu.
Jest to ważne dla wielu frontów, a jednym z nich jest kultura rolnicza.	And that is important for many fronts and one of them is because of that culture that is in agriculture.	To ważne z wielu względów np. dla kultury związanej z rolnictwem.
W większości potraw, które jadłem, nie rozpoznałem nawet połowy nazw.	I didn not even recognize half the names in most of the food that I was eating.	Nie znałam nawet nazw połowy składników.
Będziesz miał nowe zrozumienie i zaufanie do swojego ciała.	You will have a new understanding and trust in your body.	Zyskacie nowe zrozumienie i wiarę we własne ciało.
Moje ciało jest odrętwiałe z żalu.	My body is numb with grief.	Moje ciało zdrętwiało z żalu.
Nikt nigdy nie widział ewolucji.	No one has ever seen evolution.	Nikt nigdy nie widział ewolucji.
A to, co niewidzialne, musisz przyznać, nie przychodzi do nas zmysłami.	And the unseen you have to admit doesn not come to us through the senses.	A niewidzialne muszę przyznać nie daje się poznać poprzez zmysły.
W sumie siedmiu facetów wchodzi anonimowo w bieliźnie.	A total of seven guys enter anonymously in their underwear.	W sumie anomimowo wsiadło siedmu facetów w bieliźnie.
I złapali kilku moich ludzi, którzy mieli ukryte kamery w torbach marynarskich.	And they caught a couple of my guys who had hidden cameras in duffel bags.	Złapali kilku ludzi z ukrytymi kamerami w torbach.
W każdym aspekcie swojego życia pragnęli postępu, tak jak my.	In every aspect of their lives they wished for progress just as we do.	W każdej dziedzinie ich życia pragnęli postępu równie mocno jak my.
Oczywiście są w stanie reagować na grawitację, więc pędy rosną wbrew wektorowi grawitacji, a korzenie w kierunku wektora grawitacji.	They are able to respond to gravity of course so the shoots are growing against the vector of gravity and the roots toward the vector of gravity.	Reagują na grawitację tak że pędy rosną przeciwko sile grawitacji a korzenie w stronę grawitacji.
Myślałem, że okej, wyjdę.	I thought okay I will go out.	Myślałem że się uda.
Ale czasami czuję się jak ptak.	But I feel like a bird sometimes.	Ale czasem czuję się jak ptak.
I wspinam się w górę, odwracam się.	And up I climb I turn.	obniżam się lecę w górę skręcam.
Można więc rozpoznać ten rodzaj ruchu, ten sam ruch, który są w stanie pokazać robaki, węże i każde zwierzę poruszające się po ziemi bez nóg.	So you can recognize this kind of movement the same movement that worms snakes and every animal that are moving on the ground without legs is able to display.	Rozpoznajecie ten rodzaj ruchu którego używają robaki węże i wszystkie zwierzęta poruszające się bez nóg po ziemi.
I po dwóch miesiącach siedzenia pewnego dnia, myśląc, że to już koniec, ten niesamowity duży biały samiec zszedł tuż obok mnie trzy stopy ode mnie, zszedł na dół, złapał rybę, poszedł do lasu i zjadł ją.	And after two months of sitting there one day thinking that it was all over this incredible big white male came down right beside me three feet away from me and he went down and grabbed a fish and went off in the forest and ate it.	Po dwóch miesiącach takiego siedzenia pewnego dnia myśląc że to już koniec pojawił się ten niesamowity duży biały samiec tuż obok mnie niecały metr złapał rybę odszedł do lasu i ją zjadł.
Jest bezradny.	It is helpless.	Jest bezradne.
To jest pan Lopez, który przebywał w izolatce od 18 miesięcy i przedstawia informacje na temat rodzajów obrazów, które jego zdaniem sprawiłyby, że on i jego współwięźniowie byli bardziej pogodni, bardziej spokojni i mniej skłonni do przemocy.	This is Mr Lopez who has been in solitary confinement for 18 months and he is providing input on the types of images that he believes would make him and his fellow inmates more serene more calm less apt to violence.	Pan Lopez spędził w izolatce 18 miesięcy. Informuje jakie obrazy jego zdaniem przyniosłyby mu i innym więcej pogody i spokoju. a mniej skłonności do agresji.
To niedźwiedź duch lub niedźwiedź Kermode.	It is a spirit bear or a Kermode bear.	To niedźwiedź duch albo Kermode.
Musisz to odegrać.	You have to act it out.	Musisz to odegrać.
Elżbietanie określali język jako udekorowaną ciszę.	The Elizabethans described language as decorated silence.	Ludzie ery elżbietańskiej opisali język jako udekorowaną ciszę.
Musisz to sobie wyobrazić.	You are having to imagine it.	Jesteśmy zmuszeni to wymyślać.
Oznacza to, że nie trzeba czekać na zajście reakcji chemicznych, nie trzeba używać odczynników, które mogą się wyczerpać, ani być ekspertem, aby uzyskać przydatne informacje.	That means there is no waiting for chemical reactions to take place no need to use reagents that can run out and no need to be an expert to get actionable information.	Nie trzeba czekać na zajście reakcji chemicznych nie potrzeba odczynników które mogą się skończyć nie trzeba być ekspertem by zdobyć odpowiednie wyniki.
Nie chcesz być zbyt antropomorficzny, ale przysięgam, że patrzyła na mnie tak, jakby ten bezużyteczny drapieżnik umarł z głodu w moim oceanie.	You don not want to be too anthropomorphic but I swear that she looked at me like This useless predator is going to starve in my ocean.	Nie chcę być zbyt antropomorficzny ale pewnie myślała sobie Ten beznadziejny drapieżnik umrze z głodu w moim oceanie .
Drugim problemem związanym z nadużywaniem słuchawek jest kompresja.	The second problem that comes with headphone abuse is compression.	Drugi problem to kompresja.
Widzę biały budynek. Pada miękki śnieg.	I see a white building It is snowing a soft snow.	Widzę biały budynek. Pada miękki śnieg.
Jeden zestaw DNA przechodzi na jedną stronę, a druga strona otrzymuje drugi zestaw identycznych kopii DNA.	One set of DNA goes to one side the other side gets the other set of DNA identical copies of DNA.	Część DNA przechodzi na jedną stronę z drugiej mamy pozostałą część. Są to dwie identyczne kopie DNA.
I wszystkie pasują do siebie.	And they all fit together.	Tworzą spójną całość.
Tradycyjny model karze cię za eksperymenty i porażki, ale nie oczekuje mistrzostwa.	The traditional model it penalizes you for experimentation and failure but it does not expect mastery.	A w szkole dostaje się po łapach za eksperymentowanie i porażki. Co jednak dziwne nie wymaga się od nas biegłości.
Więc znowu zaczynamy od DNA.	So again we begin with DNA.	Zacznijmy znów od DNA.
Ta mała kałamarnica nazywana jest miotaczem ognia ze względu na jej zdolność do tego.	This little squid is called the fire shooter because of its ability to do this.	Ta mała kałamarnica jest nazywana również ognistą z powodu zdolności do robienia czegoś takiego.
BG A więc matematyka w piątej klasie to miejsce, w którym teraz się to dzieje.	BG So fifth grade math is where that is going on right now.	BG A więc na dzień dzisiejszy korzystają z tego pięcioklasiści ?
Narrator Przed łodzią podwodną zetknie się bałagan z miękkimi istotami z głębin morskich.	Narrator In front of the sub a mess screen will come into contact with the soft bodied creatures of the deep sea.	Narrator Siatkowy ekran umieszczony z przodu łodzi podwodnej wejdzie w kontakt z delikatnymi stworzeniami głębokiego oceanu.
Ale kiedy zejdziesz na dno oceanu, sprawy stają się naprawdę dziwne.	But when you get down to the bottom of the ocean that is where things get really strange.	Jednak kiedy dotrze się na dno oceanu może się wydarzyć coś dziwnego.
A w tradycyjnym modelu, jeśli wykonałeś migawkową ocenę, mówisz, że to są utalentowane dzieci, to są powolne dzieci.	And in a traditional model if you did a snapshot assessment you say These are the gifted kids these are the slow kids.	Natomiast w tradycyjnej szkole na podstawie testu powiedziałbyś To są bystrzejsze dzieci a to są te wolniejsze.
Zasadniczo jest to duży nadajnik mikrofalowy.	It is essentially a big microwave transmitter.	Jest to duży nadajnik mikrofal
Stephen Coleman Moralne niebezpieczeństwa związane z nieśmiercionośną bronią.	Stephen Coleman The moral dangers of non lethal weapons.	Stephen Coleman “Moralne zagrożenia związane z bronią nieśmiercionośną”.
Oto znowu Hedy Lamarr.	Here is Hedy Lamarr again.	Raz jeszcze Hedy Lamarr.
Drugiego gościa, którego nazwiemy nim Bill, ogarnęło zażenowanie, patrząc na przedmiot w środku.	The second guy we will call him Bill is transfixed by embarrassment at staring at the thing there in the center.	Ten drugi Bill jest sparaliżowany przez zażenowanie wywołane przez to coś pośrodku.
Każdy, kogo to uderzy, czuje nagły przypływ ciepła i po prostu chce zejść z drogi.	And anybody who is hit with this feels this sudden burst of heat and just wants to get out of the way.	Każdy ktokolwiek zostanie nimi porażony poczuje nagłe uderzenie gorąca i zechce się od razu usunąć z drogi.
Z drugiej strony konserwatyści opowiadają się za instytucjami i tradycjami.	Conservatives on the other hand speak for institutions and traditions.	Z drugiej strony konserwatyści opowiadają się za instytucjami i tradycjami.
Ale zawsze istnieje złudzenie, że jeśli kupisz tę lampę, będziesz żył w świecie bez przewodów.	But there is always this illusion that if you buy this lamp you will live in a world without cords.	Ale zazwyczaj wierzy się w tą iluzję że jeśli kupi się tą lampę będzie się żyło w świecie bez kabli.
Znajdziemy to w każdym kraju, na który patrzymy.	We find this in every country we look at.	Tak jest dla każdego badanego kraju.
Badamy tę rzecz, którą nazywają kinetochorem, od ponad stu lat intensywnymi badaniami i wciąż dopiero zaczynamy odkrywać, o co w tym wszystkim chodzi.	We have been studying this thing they call the kinetochore for over a hundred years with intense study and we are still just beginning to discover what it is all about.	Badamy tak zwane kinetochory intensywnie od ponad stu lat i dopiero zaczynamy odkrywać co to jest.
Wyjdź z moralnej matrycy, po prostu spróbuj postrzegać to jako rozgrywającą się walkę, w której wszyscy myślą, że mają rację i przynajmniej każdy ma jakieś powody, nawet jeśli się z nimi nie zgadzasz, każdy ma jakieś powody dla tego, co robią.	Step out of the moral matrix just try to see it as a struggle playing out in which everybody does think they are right and everybody at least has some reasons even if you disagree with them everybody has some reasons for what they are doing.	Wystąpcie z moralnego matriksu dobrze jest o tym myśleć jak o konflikcie w którym wszyscy myślą że mają rację wszyscy mają swoje pobudki nawet jeśli się z nimi nie zgadzamy. Wszyscy mają powody by robić to co robią. Wystąpcie.
I znowu nie możemy się tego dowiedzieć, ale jest jasne, że musiała pojawić się nowa forma bogactwa.	And again we have no way of knowing but it is clear that a new form of wealth must have emerged.	I raz jeszcze nie mamy sposobu poznania ale jasne jest że pojawia się nowa forma bogactwa.
Chciałbym podzielić się jedną krótką winietą.	And I would like to share one short vignette.	Posłuchajcie tego.
Czerwoni Khmerzy nie wierzyli w pieniądze.	The Khmer Rouge didn not believe in money.	Czerwoni Khmerzy nie wierzyli w wartość pieniędzy
Natomiast jeśli uważa, że ​​proszek był trucizną, mimo że jest to naprawdę cukier, to teraz ludzie mówią, że zasługuje na dużą winę, mimo że to, co wydarzyło się w prawdziwym świecie, było dokładnie takie samo.	Whereas if she thinks the powder was poison even though it is really sugar now people say she deserves a lot of blame even though what happened in the real world was exactly the same.	Jeśli uważa proszek za truciznę nawet jeśli to cukier uważa się jej postępowanie za naganne choć następstwa niczym się nie różnią.
Teraz Elinor Ostrom, politolog w 1990 roku, zadała interesujące pytanie, które powinien zadać każdy dobry naukowiec, ponieważ jest prawdą, że ludzie zawsze będą rabować dobra wspólne.	Now Elinor Ostrom a political scientist in 1990 asked the interesting question that any good scientist should ask which is is it really true that humans will always despoil commons.	Teraz Eleanor Ostrom politolog w 1990 zadała interesujące pytanie które każdy dobry naukowiec powinien zadać które brzmi czy prawdą jest że ludzie będą zawsze profanować dobra wspólne?
Rebecca Saxe To, jak się czytamy, to umysły.	Rebecca Saxe How we read each other is minds.	Rebecca Saxe W jaki sposób umysł dokonuje sądów moralnych.
Oczywiście rozwój nie kończy się na piątej.	Now of course development doesn not end at five.	Rzecz jasna rozwój nie kończy się w wieku 5 lat.
I wolność od prześladowań ze strony Czerwonych Khmerów.	And freedom from persecution from the Khmer Rouge.	I wolność od prześladowań Czerwonych Khmerów.
Więzień jest dylematem to w rzeczywistości historia nałożona na matematyczną matrycę, która wyszła z teorii gier we wczesnych latach myślenia o wojnie nuklearnej dwóch graczy, którzy nie mogli sobie ufać.	The prisoner is dilemma is actually a story that is overlaid on a mathematical matrix that came out of the game theory in the early years of thinking about nuclear war two players who couldn not trust each other.	Dylemat więźnia jest właściwie historią bazującą na matematycznej macierzy która powstała z Teorii Gier we wczesnych latach przemyśleń na temat wojny nuklearnej dwóch graczy którzy nie mogli sobie ufać.
Zatem moim zadaniem w dziedzinie neuronauki poznawczej jest trzymanie się tych idei po jednym w każdej ręce.	So the job of my field of cognitive neuroscience is to stand with these ideas one in each hand.	Zadaniem mojej dziedziny neurobiologii kognitywnej jest porównanie tych idei jest porównanie tych idei
Tym razem zmieniła się tekstura bębnów.	The texture changed in the drums this time.	Perkusja też zabrzmiała inaczej.
Chcę to zatrzymać na chwilę, ponieważ film jest bardzo kiepsko nakręcony.	I want to stop it for a second because the movie is very badly made.	Zatrzymamy się na chwilę bo to nienajlepsze nagranie.
A jeśli ta osoba przerwie, te dwie głowy mogą się odwrócić.	And then if that person interrupts then those two heads may turn.	A jeśli tamta osoba im przerwie te głowy mogą zwrócić się do niej.
Edukacja synteza mądrości i wiedzy jest środkiem do dążenia do doskonalszego, bardziej świadomego, szlachetniejszego i bardziej sprawiedliwego społeczeństwa.	Education the synthesis of wisdom and knowledge is the means to strive for a more perfect more aware more noble and more just society.	Jako synteza mądrości i wiedzi edukacja jest tym co pozwala dążyć do osiągnięcia doskonalszego bardziej świadomego szlachetnego i sprawiedliwego społeczeństwa.
Wylęgły się w Indiach.	They hatched out in India.	Wykluły się w Indiach.
Będą to pewne proste cechy projektowe, a także niektóre cechy, jeśli zechcesz inteligencji interakcji.	And these will be some simple design qualities and they will also be some qualities of if you will the intelligence of interaction.	Ulepszenia takie dotyczą cech konstrukcyjnych ale także czegoś co nazwę inteligencją interakcji . ale także czegoś co nazwę inteligencją interakcji .
Powrót do Yad Vashem trzy lata temu Po tym, jak ten cały epizod się rozpoczął, Yad Vashem zdecydował się całkowicie przebudować muzeum historyczne, ponieważ teraz w Waszyngtonie powstało Muzeum Holokaustu w Waszyngtonie, które jest o wiele bardziej obszerne pod względem informacji.	Back to Yad Vashem three years ago After all this episode began Yad Vashem decided to rebuild completely the historic museum because now Washington was built the Holocaust Museum in Washington and that museum is so much more comprehensive in terms of information.	Wracamy do Yad Vashem 3 lata temu. Gdy zaczęła się ta historia Yad Vashem zdecydowało kompletnie przebudować muzeum ponieważ gotowe było już Muzeum Holokaustu w Waszyngtonie dużo bardziej szczegółowe jeśli chodzi o informacje.
Wydobywa się tu z oceanu i jest ciągnięty w kierunku Indii.	It comes off the ocean here and is drawn up towards India.	Napływa ku Indiom stąd z południowego zachodu.
Teraz monsun, rdzeń słowa monsun pochodzi od słowa pora roku.	Now monsoon the root of the word monsoon comes from the word season.	To określenie pochodzi od słowa znaczącego pora roku .
Ci z was z północnych Indii będą z tym zaznajomieni.	Those of you from northern India will be familiar with this.	znane w północnych Indiach.
Jest pełen wszelkiego rodzaju żyroskopów i kół pasowych, gadżetów i łożysk kulkowych, które nie działają tak dobrze, jak powinny w ogniu bitwy.	It is full of all kinds of gyroscopes and pulleys and gadgets and ball bearings and they don not work as well as they ought to in the heat of battle.	Jest w nim pełno żyroskopów rolek urządzeń i łożysk które nie funkcjonują najlepiej w ogniu walki.
Dziękuję Ci.	Thank you.	Dziękuję.
To było niezwykłe.	It was extraordinary.	To było wyjątkowe.
Jesteśmy gotowi poświęcić 15 lat na naukę.	We are ready to spend 15 years achieving education.	Jesteśmy gotowi spędzić 15 lat na zdobycie wiedzy.
Jeśli posadzisz faceta na krześle z całym tego rodzaju aparaturą mierzącą twoją fizjologię i jest taka bomba, która wybucha, to jest to tak instynktowna reakcja, że ​​za 20 lat nie widzieli nikogo, kto nie skoczy.	If you sit a guy on a chair with all this kind of apparatus measuring your physiology and there is kind of a bomb that goes off it is so instinctive response that in 20 years they never saw anyone who will not jump.	Kiedy facet z różnymi przyrządami mierzącymi fizjologię usłyszy coś jak wybuch bomby reaguje instynktownie. W ciągu 20 lat nie widzieli nikogo kto by nie podskoczył.
To lepsze niż świecący kurczak.	That is better than a glowing chicken.	To lepsze od świecącego kurczaka.
I znowu może to być coś, co nie jest czymś, co promieniuje na zewnątrz.	And also again it can also it is something that you it is not something that is radiating outside.	Po za tym przyjemność nie emanuje na zewnątrz.
Chodzi mi o to, że prawdopodobnie widziałeś te nagłówki. To Catherine Casey, która jest pierwszym boomerem, który faktycznie uzyskał ubezpieczenie społeczne.	I mean you probably saw these headlines This is Catherine Casey who is the first boomer to actually get Social Security.	Prawdopodobnie widzieliście te nagłówki. To jest Catherine Casey która jest pierwszą osobą z wyżu która dostała świadczenie socjalne.
I sprawia, że ​​ta rzecz jest skomplikowana.	And he makes this complicated thing.	Norden buduje maszynę
Myślimy, że gdybyśmy mogli zebrać to i to wszystko warunki coś, co powiemy Wszystko, aby być szczęśliwym, aby mieć wszystko, aby być szczęśliwym.	We think that if we could gather this and that all the conditions something that we say Everything to be happy to have everything to be happy.	Sądzimy że jeśli uzbieramy to i owo spełnimy warunki. Mówimy wszystko co potrzebne do szczęścia. Mieć wszystko potrzebne do szczęścia.
Możesz zrobić wszystko.	You can kind of do anything.	Możesz zrobić wszystko.
To nie jest zwierzę, którego rysujemy lub w ogóle rysujemy.	It is not an animal we draw cartoons of or draw at all.	Nie jest to zwierzę do kreskówek czy w ogóle do rysowania.
A z drugiej strony, jeśli mają na to ochotę i nie zamierzają tego robić w każdym przypadku, ale w wielu z nich chcą faktycznie sprzedać to dzieło jako sposób na zapewnienie sobie środków do życia.	And then the second one is if they feel like it and they are not going to do it in every case but in many they are they want to actually be able to sell that creation as a way of providing for their own livelihood.	Natomiast drugi to nie w każdym przypadku ale w wielu możliwość sprzedaży produktów własnej wyobraźni w sensie zarobkowym.
Ale bardziej ogólnie znasz jeszcze jeden przykład, o którym myślę, który jest świetny w stosunku do utopijnej idei.	But more generally you know one other example I think about this which is great relative to the utopian idea.	Ale mam jeszcze jeden przykład jest blisko związany z ideą utopii.
Dziesiątki milionów z nich myśli przez cały czas, gdy mają dołączony do nich kod.	Tens of millions of them are thinking all the time they have code attached to them.	10 milionów cały czas myśli każdy z nich ma przypisany własny kod.
Więc jeśli kiedykolwiek marzyłeś o cofnięciu się w czasie i zobaczeniu, jak wyglądał dinozaur, tak właśnie wygląda dinozaur.	So if you ever fantasize about going back in time and seeing what a dinosaur looked like that is what a dinosaur looks like.	Jeśli marzyłeś o cofnięciu się w czasie i zobaczeniu jak wyglądał dinozaur oto jak wyglądał.
Z drugiej strony wiemy, że ta broń daje przewagę podczas ataku.	On the other hand we know that these weapons give an advantage to attacking.	Z drugiej strony wiemy że te bronie dają przewagę atakującemu.
Jeśli pamiętasz zimną wojnę, była to bardzo trudna gra, ale stabilna rozgrywana tylko przez dwóch graczy, co pozwoliło na pewną koordynację między dwoma supermocarstwami.	If you remember the Cold War it was a very hard game but a stable one played only by two players which allowed for some coordination between the two superpowers.	Jeśli pamiętacie zimną wojnę była to bardzo ciężka gra ale stabilna ponieważ grana przez tylko 2 graczy co pozwoliło na koordynację między dwoma imperiami.
W końcu moja mama zabrała czerwoną kredkę, więc było to niejasne.	Eventually my mom took the red crayon away so it was unclear.	W końcu mama zabrała czerwoną kredkę.
Jedną z nich jest sprawiedliwa własność rzeczy, które tworzą.	One is fair ownership of the things they create.	Pierwszy prawo posiadania własnoręcznie stworzonych rzeczy.
A ten mózg uczy się z prędkością warp.	And that brain is learning at warp speed.	A mózg uczy się z prędkością nadświetlną.
AB 987 do kwadratu to 974169.	AB 987 squared is 974169.	AB 987 do kwadratu daje 974.169.
Jak ostatnio mamy wspólne pochodzenie.	Now how recently do we share this ancestry.	Od jak dawna dzielimy wspólny rodowód?
Chris Anderson Tak AB Tak OK Powiem ci, co Chris tak długo, jak będziesz mieć tę książkę przed sobą, wyświadcz mi przysługę, przechodząc w rok poza 1900 albo w 1800, albo w 2000, który będzie znacznie większy wyzwanie dla mnie.	Chris Anderson Yes AB Yeah OK I will tell you what Chris as long as you have that book in front of you do me a favor turn to a year outside of the 1900s either into the 1800s or way into the 2000s that will be a much greater challenge for me.	Chris Anderson Zgadza się. AB Dobrze. Wiesz co? Dopóki trzymasz tę książkę zrób mi przysługę i przewróć poza rok 1900 do 1800 lub w głąb 2000 będzie to dla mnie większym wyzwaniem.
Składał się z ogromnych chmur atomów wodoru i helu i nie ma żadnej struktury.	It consisted of huge clouds of hydrogen and helium atoms and they have no structure.	Składał się z wielkich chmur atomów wodoru i helu które nie miały żadnej struktury.
AB Myślę, że pominąłeś numer 3.	AB I think you left out the number 3.	AB Sądzę że pominął Pan cyfrę 3.
Sam zdecydujesz, czy chcesz oddać swoje narządy, czy nie.	You will decide whether you want to donate your organs or not.	Decydujesz czy chcesz zostać dawcą czy nie. Decydujesz czy chcesz zostać dawcą czy nie.
Więc kopiuje się i rozprasza szablony przez ocean.	So it copies itself and scatters the templates through the ocean.	Samodzielnie się namnaża i rozprzestrzenia szablony w całym oceanie.
Tak więc wielka historia może pokazać nam naturę naszej złożoności i kruchości oraz niebezpieczeństw, które przed nami stoją, ale może również pokazać nam naszą siłę dzięki zbiorowej nauce.	So what big history can do is show us the nature of our complexity and fragility and the dangers that face us but it can also show us our power with collective learning.	Co może zrobić Wielka Historia? Może pokazać nam naturę naszej złożoności i delikatności oraz niebezpieczeństwa którym musimy stawić czoło ale może również ukazać nam potęgę zbiorowej nauki.
CA 1824.	CA 1824.	CA 1824.
Ale spójrz na twarz i mowę ciała wszystkich na tym rozmytym zdjęciu, a poczujesz, że wszyscy się bawią.	But take a look at the face and the body language of everybody in this fuzzy picture and you can get a sense that they are all at play.	Spójrzcie teraz na twarze i język ciała wszystkich na tym zdjęciu można domyślić się że się bawią.
Wynoś się z tego, wyciągnij to.	Get out of it get it out.	Wyjdź z niego. Wydostań go.
02 metry stąd, do tego 20 centymetrów.	02 meters from here back to here 20 centimeters.	02 metra stąd dotąd 20 centymetrów.
I wszyscy mówimy o tej wspaniałej angielskiej ikonie i mówimy, że jest fantastyczną kobietą, robi wszystko.	And we are all talking about this great English icon and saying She is a fantastic woman she does everything.	I tak sobie wszyscy gadamy o tej wielkiej brytyjskiej idolce i mówimy Ona jest fantastyczną kobietą. Ona robi wszystko.
Oszczędzaj więcej jutro ułatwia to.	Save More Tomorrow makes it easy.	Rozwiąże je program Zaoszczędź więcej jutro”.
Goście Przenieś ruchomą ścianę mają składane łóżka dla gości.	Guests Move the moving wall have some fold down guest beds.	Goście? Za ruchomą ścianą są rozkładane łóżka.
Oprócz tego zmierzyliśmy prędkość dźwięku.	In addition to that we have measured the speed of sound.	Dodatkowo zmierzyliśmy prędkość dźwięku.
Stanowiła część ustawy o ochronie emerytalnej.	It is been part of the Pension Protection Act.	Jest częścią Pension Protection Act.
Więc obeszliśmy stół ze studiem, producentami i scenarzystą, a oni przyszli do mnie i powiedzieli Shekharowi, co o tym myślisz.	So we went around the table with the studio and the producers and the writer and they came to me and said Shekhar what do you think.	Daliśmy szansę wypowiedzieć się każdemu ludziom ze studia producentom i scenarzyście a kiedy przyszła kolej na mnie powiedzieli Shekhar co o tym sądzisz?
Średnia faktycznie rekord jest w Singapurze.	The average actually the record is in Singapore.	mieszkańcy Singapuru gdzie przeciętne gospodarstwo domowe.
No dalej, wstawaj.	Come on Get up.	No dalej wstawaj.
Trudno jest po prostu dostać się automatycznie.	They are hard to just get automatically.	trudno od razu zrozumieć.
Żaden z nich nie uczęszczał na uniwersytet.	Neither of them attended university.	Rodzice nigdy nie studiowali.
To dlatego wszystko to, że przechodzisz przez wzloty i upadki nauczycieli, których kochasz i nauczycieli, których nie robisz, jest tak ważne.	That is why all of this that you are going through the ups and the downs the teachers that you love and the teachers that you don not why it is so important.	Dlatego wszystkie wasze wzloty i upadki nauczyciele lubiani i nielubiani mają takie znaczenie.
I to jest coś, co zawsze kierowało wszystkimi jego wyborami.	And it is something that always drove all his choices.	To decydowało o wszystkich jego decyzjach.
Dla mnie nie ma większej zdolności niż dar innej istoty ludzkiej, który daje ci to uczucie, aby utrzymać ich nieruchomo tylko na krótką chwilę ich dnia i sprawić, by poddali się zdumieniu.	For me there is no greater ability than the gift of another human being giving you that feeling to hold them still just for a brief moment in their day and have them surrender to wonder.	Według mnie nie ma większej umiejętności niż podarowanie drugiemu człowiekowi właśnie tego uczucia zatrzymać go na krótką chwilę w ciągu dnia i sprawić że się podda i zdziwi.
Postanowiliśmy zrobić coś nieco innego i przekształcić dobrze nam znane smaki, więc w tym przypadku mamy ciasto marchewkowe.	We decided to do something a little bit different and transform flavors that were very familiar so in this case we have carrot cake.	Postanowiliśmy zrobić coś innego modyfikując znane smaki w tym przypadku marchewkowe ciasto.
Zobaczysz, że ten kurs ma na celu zbadanie ludzkiego stanu gry, który przypomina stan husky niedźwiedzia polarnego i jego znaczenie dla kreatywnego myślenia w celu zbadania zachowań związanych z zabawą, jego rozwoju i biologicznych podstaw do zastosowania tych zasad poprzez myślenie projektowe w celu promowania innowacji w świecie korporacji, a studenci będą pracować z partnerami ze świata rzeczywistego nad projektami o szerokim zastosowaniu.	And you will see this course is to investigate the human state of play which is kind of like the polar bear husky state and its importance to creative thinking to explore play behavior its development and its biological basis to apply those principles through design thinking to promote innovation in the corporate world and the students will work with real world partners on design projects with widespread application.	Zobaczycie zaraz że jego celem jest zbadanie stanu zabawy u ludzi podobnego do zabawy niedźwiedzia z huskym oraz jego wpływu na kreatywne myślenie odkrycie zabawy jej powstania i biologicznych podstaw. Zastosowanie jej zasad w projektowaniu promowanie innowacji w świecie biznesu. Studenci będą pracować z rzeczywistymi partnerami nad designem jako narzędziem o szerokim zastosowaniu.
Potrzebujemy silnych, inteligentnych, pewnych siebie młodych kobiet, które staną i przejmie stery.	And we need strong smart confident young women to stand up and take the reins.	Potrzeba nam silnych bystrych pewnych siebie kobiet by powstały i przejęły wodze.
Wróćmy więc do Sudanu.	So let is go back to Sudan.	Wróćmy więc do Sudanu.
Utrudnia to uznanie naszego równego człowieczeństwa.	It makes our recognition of our equal humanity difficult.	Trudno jest rozpoznać innych jako równych
A co by było, gdyby moja współlokatorka wiedziała o mojej przyjaciółce Fumi Onda, nieustraszonej kobiecie, która prowadzi program telewizyjny w Lagos i jest zdeterminowana, by opowiedzieć historie, o których wolimy zapomnieć.	Now what if my roommate knew about my friend Fumi Onda a fearless woman who hosts a TV show in Lagos and is determined to tell the stories that we prefer to forget.	Co jeśli współlokatorka znała Fumi Onda dzielną dziennikarkę w Lagos opowiadającą historie o których wygodniej zapomnieć?
Mówiąc Kim jest ta osoba w lustrze Och, to naprawdę ja.	By saying Who is that person in the mirror Oh it is actually me.	Mówiąc sobie “Kim jest ta postać w lustrze? Ach to właśnie ja.”.
I tak narodził się projekt o nazwie Remark, będący wynikiem współpracy z Zacharym Liebermanem i Ars Electronica Futurelab.	And thus was born the project called Remark which is a collaboration with Zachary Lieberman and the Ars Electronica Futurelab.	Tak narodził się projekt Remark  realizowany we współpracy z Zacharym Liebermanem i Ars Electronic Futurelab.
To tylko część twojego sąsiedzkiego obowiązku.	It is just part of your neighborly duty.	To tylko część sąsiedzkiego obowiązku.
Teraz może się wydawać, że dziś jest mniej nadziei niż wcześniej.	Now it may seem like there is less hope today than there was before.	Może się wydawać że obecnie jest mniej nadziei niż kiedyś.
A w moim przypadku, gdy uderzę w wyślij, nawet 60000 osób otrzyma tę wiadomość w ciągu kilku sekund.	And in my case when I hit send up to 60000 people will receive that message in a matter of seconds.	nawet 60 000 ludzi dostanie tą wiadomość w ciągu kilku sekund. nawet 60 000 ludzi dostanie tą wiadomość w ciągu kilku sekund.
Nie mam pojęcia, co będzie dalej z Twitterem.	I have no idea what will happen next with Twitter.	Nie mam pojęcia co stanie się teraz z Twitterem
Jestem w Carnegie Mellon, mamy tam wspaniały Instytut Robotyki.	I am at Carnegie Mellon we have got a great Robotics Institute there.	w Carnegie Mellon. Mamy tam wspaniały Instytut Robotyki.
Na przykład są różne kolory, a każdy kolor ma inny rodzaj śpiewanego pop country i zachodniego jazzu operowego i po prostu musisz być spójny z tym kolorem.	For example there are different colors and each color gets a different type of singing pop country and western opera jazz and you just have to be consistent with that color.	Przykładowo są tu różne kolory i każdy kolor oznacza inny styl śpiewania pop country opera jazz i trzeba być konsekwentnym co do tego koloru.
Golimy to i mam mały obiektyw grawitacyjny OK.	We shave it off and I have a little gravitational lens OK.	Przerabiam ją w soczewkę grawitacyjną.
Więc gdybym cię zapytał, dlaczego nie pójdziesz i znajdź mi chorobę w Burkina Faso w 1991 roku.	So if I asked you Why don not you go and find me the prevalence in Burkina Faso in 1991.	Powiedzmy że chcecie znaleźć dane z Burkina Faso w 1991 roku.
Jeśli są lekko przekrzywione, zobaczymy inny obraz.	If they are slightly skewed we will see a different image.	Jeśli nie obraz będzie inny.
Ale potem dość szybko wyzdrowiały.	But they did recover quite fast afterwards.	Ale dość szybko stanęli na nogi po jej zakończeniu.
Jeśli jest stożek światła wpadający do mojego oka, co widzę.	If there is a cone of light coming into my eye what do I see.	Jak oko odbiera taki stożek?
Myślę, że można się czegoś nauczyć z historii Europy.	In my mind there is something to learn from the history of Europe.	Sądzę że możemy nauczyć się czegoś z historii Europy.
Więc wszystkie te galaktyki się poruszają.	So all of these galaxies are moving.	Wszystkie krążą.
Mam też organizację charytatywną zajmującą się informacją, która wykonała ogromną pracę w Indiach.	And I have an information charity which has done huge scale amount of work in India.	A do tego mam wsparcie organizacji charytatywnej która wykonała ogromną masę pracy w Indiach.
A teraz przyłóż soczewkę do galaktyki, a zobaczysz, że zobaczysz pierścień i pierścień Einsteina.	And now put the lens over the galaxy and what you will find is that you will see a ring an Einstein ring.	Po zakryciu galaktyki soczewką widzimy pierścień Einsteina.
Młode kobiety mieszkające na obszarach o wysokiej śmiertelności matek zmieniają swoje zachowanie mniej w odpowiedzi na HIV niż młode kobiety mieszkające na obszarach o niskiej śmiertelności matek.	Young women who live in areas with high maternal mortality change their behavior less in response to HIV than young women who live in areas with low maternal mortality.	Młode kobiety na obszarach z wysoką śmiertelnością matek mniej zmieniają zachowanie w reakcji na HIV niż kobiety w innych miejscach.
Co więcej, wiedział, że nie zagraża to jego wyborowi, wręcz przeciwnie.	More to the point he knew it posed no threat to his election quite the contrary.	Dobrze wiedział że nie zaszkodzi mu to w wyborach. Przeciwnie.
Tak się stało, gdy robimy bailouty.	While we are doing bailouts this is what happened.	My ratujemy banki a dzieje się to.
Dobrze, aby się rozmnażać.	Well in order to reproduce.	Bo chcą się rozmnażać.
To byłby wspaniały artykuł.	Now this would have been a wonderful paper.	Piękna teoria.
Używamy pięciu polimerów w świecie przyrody, aby robić wszystko, co widzisz.	We use five polymers in the natural world to do everything that you see.	Przyroda wszystko to wykonuje za pomocą 5 polimerów. Przyroda wszystko to wykonuje za pomocą 5 polimerów.
Wśród biologów liczba ta jest jeszcze niższa. 55 procent wierzy tylko w Boga. Fizycy, to jest 75 procent.	Among biological scientists the figures are even lower 55 percent only believe in God Physical scientists it is 75 percent.	Wśród biologów ten wynik jest jeszcze niższy. Zaledwie 55 % z nich wierzy w Boga i 75 % fizyków.
Infekcje szpitalne zabijają obecnie każdego roku w Stanach Zjednoczonych więcej ludzi niż umiera z powodu AIDS, raka lub wypadków samochodowych łącznie około 100 000.	Hospital acquired infections are now killing more people every year in the United States than die from AIDS or cancer or car accidents combined about 100000.	Zakażenia nabyte w szpitalach zabijają w USA co roku więcej osób niż łączenie AIDS nowotwory i wypadki samochodowe. Około 100 tysięcy.
A to, co staramy się zrobić w sposób typowy dla TED, to uporządkowanie wszystkich informacji biologicznych według projektu i funkcji inżynieryjnej.	And what we are trying to do in a TEDesque way is to organize all biological information by design and engineering function.	Robimy tam coś bardzo TED owskiego. Organizujemy informację biologiczną względem przydatności dla projektantów i inżynierów.
I tak pierwsza myśl, która przyszła nam do głowy, to to, że wszędzie, gdzie parkujemy, mamy energię elektryczną.	And so the first thought that came to mind is everywhere we park we have electric power.	Zatem trzeba stworzyć możliwość ładowania akumulatora na każdym postoju.
To jest pytanie, które uderzyło mnie w środku popołudnia w Davos około cztery lata temu.	That is the question that sort of hit me in the middle of a Davos afternoon about four years ago.	Takie pytanie naszło mnie w Davos jakieś cztery lata temu.
A potem zacząłem dobrze myśleć, że oczywiście nie możemy po prostu pozbyć się CAPTCHA, ponieważ w pewnym sensie od nich zależy bezpieczeństwo sieci.	And then I started thinking well of course we can not just get rid of CAPTCHAs because the security of the Web sort of depends on them.	Potem pomyślałem sobie że nie można po prostu zrezygnować z tych kodów ponieważ zależy od nich bezpieczeństwo sieci.
A jeśli powtórzymy ten proces, aby polubić 10 różnych osób i wszyscy zgodzą się co do nowego słowa, otrzymamy dokładne zdigitalizowane słowo więcej.	And if we repeat this process to like 10 different people and all of them agree on what the new word is then we get one more word digitized accurately.	Jeśli powtórzymy proces w przypadku 10 osób i wszyscy zgodnie przepiszą dane słowo zyskujemy kolejne poprawnie zdigitalizowane słowo.
Szczególnie w przypadku starszych książek, w których atrament wyblakł, a strony zmieniły kolor na żółty. OCR nie może rozpoznać wielu słów.	Especially for older books where the ink has faded and the pages have turned yellow OCR cannot recognize a lot of the words.	Szczególnie w przypadku starszych książek gdzie tusz wyblakł a strony pożółkły. OCR nie rozpoznaje wielu słów
We wrześniu mieliśmy zaskakujące, ale ekscytujące odkrycia z badania klinicznego, które odbyło się w Tajlandii.	In September we had surprising but exciting findings from a clinical trial that took place in Thailand.	We wrześniu mieliśmy niezwykle ekscytujące i zaskakujące odkrycie podczas eksperymentu klinicznego przeprowadzonego w Tajlandii.
Kiedy jesteś zaszczepiony, masz siły w swoim ciele wstępnie wyszkolone do rozpoznawania i pokonywania określonych wrogów.	When you are pre immunized what happens is you have forces in your body pre trained to recognize and defeat specific foes.	Ale jeśli w jakiś sposób nabierzesz wcześniej odporności twoje ciało natychmiastowo rozpoznaje intruza i atakuje go.
Tak to działa.	That is how it works.	Tak to działa.
Swoją drogą, dobrze mnie usłyszałeś, jego nazwisko to Hacker.	By the way you did hear me correctly his last name is Hacker.	Tak poza tym dobrze usłyszeliście nazywa się Hacker .
Jesteśmy wdzięczni, ale wiemy, że możemy przejąć kontrolę nad własnym losem, jeśli mamy wolę reform.	We are grateful but we know that we can take charge of our own destinies if we have the will to reform.	Doceniamy to ale wiemy też że jesteśmy w stanie zająć się swoim losem jeżeli będziemy chcieli przeprowadzić reformy.
Więc fajną rzeczą w Duolingo jest to, że myślę, że zapewnia uczciwy model biznesowy, który nie dyskryminuje biednych ludzi.	So the nice thing about Duolingo is I think it provides a fair business model one that doesn not discriminate against poor people.	Fajne w Duolingo jest to że opiera się na uczciwym modelu biznesowym który nie dyskryminuje ludzi biednych.
Najlepszym sposobem, aby pomóc Afrykanom w dzisiejszych czasach, jest pomóc im stanąć na własnych nogach.	The best way to help Africans today is to help them to stand on their own feet.	Najlepszym sposobem na pomaganie mieszkańcom Afryki dziś jest udzielenie im pomocy w tym aby stanęli na własnych nogach.
Tania sieć restauracji rodzinnych dla tych z Was, którzy o tym nie wiedzą.	Low cost family restaurant chain for those of you who don not know it.	Sieć tanich rodzinnych restauracji dla tych z Was którzy nie wiedzą.
Rozważ dobrze wysłać kogoś do Nashville Pick.	Consider sending somebody to Nashville Pick well.	Pomyślcie o wysłaniu kogoś do Nashville. I wybierzcie dobrze.
Więc kiedy dorastałem na naprawdę wiejskim obszarze w Maine, Internet miał dla mnie zupełnie inne znaczenie.	So when I was growing up in a really rural area in Maine the Internet meant something very different to me.	Kiedy dorastałem na wsi w stanie Maine Internet oznaczał dla mnie coś bardzo odmiennego.
Pluton egzekucyjny wycelował, a generał nie żył.	The firing squad aimed fired the general was dead.	Oddział wojskowy wycelował strzelił generał był martwy.
Jedna szósta PKB Indii pochodzi z Bombaju.	One sixth of the GDP in India is coming out of Mumbai.	Jedna szósta PKB Indii wytwarzana jest w Mumbaju.
Współpraca z Larrym Lessigiem będzie gdzieś w tym procesie publikowana z narzędziami i ograniczonymi prawami autorskimi, aby młodzi ludzie mogli to zremiksować i zrobić to na swój sposób.	Working with Larry Lessig it will be somewhere in that process posted with tools and limited use copyrights so that young people can remix it and do it in their own way.	Dzięki współpracy z Larrym Lessigiem kiedyś w trakcie tego procesu pokaz zostanie udostępniony z narzędziami i pewnymi prawami autorskimi żeby młodzi ludzie mogli go remixować i prowadzić tak jak chcą.
Ale kiedy czytasz linki, jest to naprawdę niezwykłe.	But when you do read the links it is really quite remarkable.	Jeżeli przeczytasz linki to znajdziesz coś niezwykłego.
Inne grupy etniczne, które miały wodzów, upewniły się, że otoczyły ich radami po radach po radach, aby zapobiec nadużywaniu ich władzy.	The other ethnic groups which did have chiefs made sure that they surrounded the chiefs with councils upon councils upon councils to prevent them from abusing their power.	Inne grupy etniczne które mają przywódców wymagają aby przywódcy konsultowali się z radami i starszyznami plemiennymi aby nie dopuścić do obrócenia się przywódców przeciwko ludowi.
W tym miejscu musimy zmobilizować Afrykanów w diasporze, zwłaszcza do zainwestowania w to.	This is where we need to mobilize Africans in the Diaspora especially to invest in this.	Musimy zmobilizować Afrykanów zwłaszcza w diasporze aby zainwestowali w tą dziedzinę.
Ponad 80 procent Wybrzeża Kości Słoniowej to rozwój związany z sektorem nowoczesnym.	More than 80 percent of Ivory Coast is development went into the modern sector.	Ponad 80% rozwoju Wybrzeża Kości Słoniowej przypada na nowoczesny sektor.
Zostało to zrobione pod cmentarzem Montparnasse, gdzie znajduje się większość ossuariów.	This was taken under the Montparnasse Cemetery where most of the ossuaries are located.	To zdjęcie przedstawia podziemia Cmentarza Montparnasse gdzie znajduje się większość ossuariów.
Tak jak jedno pasmo spaghetti styka się z wieloma innymi pasmami na twoim talerzu, jeden neuron dotyka wielu innych neuronów poprzez splątane gałęzie.	Just as one strand of spaghetti contacts many other strands on your plate one neuron touches many other neurons through their entangled branches.	Tak jak jedna nitka makaronu łączy się z wieloma innymi na talerzu podobnie neurony dotykają innych przez rozgałęzienia.
To prawie to, co powinieneś mieć na swojej kartce.	That is pretty much what you should have on your piece of paper Right.	coś takiego pewnie narysowaliście.
ZK Słusznie To właśnie to zaczęło rozmowę z profesorem Suslickiem i mną, a on wyjaśniał mi, co to umożliwia, poza wykrywaniem zepsutego jedzenia. Tak naprawdę leży to w znaczeniu.	ZK Right It was that that started a conversation with Professor Suslick and myself and he was explaining to me the things that this is making possible beyond just detecting spoiled food It is really where the significance of it lies.	ZK Tak jest. Tak zaczęła się moja rozmowa z profesorem Suslickiem który wytłumaczył mi w jaki sposób jest to możliwe. Ale prawdziwe znaczenie tego odkrycia leży poza zastosowaniem go do wykrywania zepsutego jedzenia.
Tym właśnie zajmują się rośliny.	That is what plants actually do for a living.	Bez tego rośliny nie przeżyją.
Przychodzą ze swoimi własnymi pomysłami i własnymi teoriami i jeśli nie będziesz z nimi pracować, nie będziesz w stanie ich zmienić. I prawdopodobnie nie zmieniłem też twoich pomysłów na to, jak działa świat i wszechświat.	They come with their own ideas and their own theories and unless you work with those then you won not be able to shift them right And I probably haven not shifted your ideas of how the world and universe operates either.	Mają własne pomysły i teorie. Żeby je zmienić musimy o tym pamiętać. Pewnie nie zmieniłem waszych modeli wszechświata. Pewnie nie zmieniłem waszych modeli wszechświata.
Teraz, skoro jesteście naprawdę wspaniali, może możecie mnie rozbawić i powiedzieć to wszystko razem.	Now since you guys are really great maybe you can humor me and say this all together too.	Świetnie nam się współpracuje więc spróbujmy to też powiedzieć razem.
W rzeczywistości zadziwiająco wplątali w to hiszpański rząd.	They implicated actually the Spanish government amazingly.	Wciągnęli w to nawet rząd hiszpański.
Ponadto jest wydzielony z firmy ChemSensing, która zajmuje się sprzętem medycznym na uniwersytecie.	In addition he is spun off a company from the University called ChemSensing where they are working on medical equipment.	Ponadto prof. Suslick stworzył firmę odpryskową powiązaną z uniwersytetem o nazwie ChemSensing gdzie pracuje się nad sprzętem medycznym
To dużo informacji.	That is a lot of information.	To mnóstwo informacji.
LC Miejmy nadzieję, że w ciągu najbliższych dwóch lat.	LC Hopefully within the next two years.	LC Mam nadzieję że w ciągu najbliższych dwóch lat.
Nity zastępowały kleje.	Adhesives were replacing the rivets.	Nity zostały zastąpione substancją klejącą.
Byłem więc przekonany, że jeśli w jakiś sposób uda nam się sprawić, by rzeczy naśladowały życie, pójdźmy o krok dalej.	So I was positive that if somehow we can make things mimic life let is go one step further.	Byłem pewny że skoro możemy stworzyć rzeczy udające życie możemy pójść krok dalej.
Oto obywatel amerykański i jego syn ze sztuczną stopą.	Here is an American citizen and his son having an artificial foot.	Tu jest Amerykański obywatel i jego syn mający sztuczne stopy.
Wygląda absolutnie niedorzecznie.	Looks absolutely ridiculous.	Wygląda to całkowicie niedorzecznie.
Mamy więc jakąś pierwotną zupę.	So we have some kind of primordial soup.	Mamy jakiś rodzaj pierwotnej zupy.
Spójrz tutaj, musisz skończyć z ubóstwem edukacja płeć dziecka i zakażenia kontroli zdrowia matki chronią środowisko i uzyskać dobre globalne powiązania między narodami we wszystkich aspektach, od pomocy po handel.	Look here you have to end poverty education gender child and maternal health control infections protect the environment and get the good global links between nations in every aspect from aid to trade.	Musisz wyeliminować biedę poprawić edukację zadbać o życie dzieci i matek kontrolować infekcje ochraniać środowisko i połączyć ze sobą nacje w każdym aspekcie od pomocy charytatywnej do handlu.
W rogu jednej z tych notatek znajduje się notatka, która mówi, kiedy zapytamy Cię, co myślisz o konwencjonalnym foie gras.	And in the corner of one of these one of my notes is this note that says when asked what do you think of conventional foie gras.	W rogu jednej strony zapisałem jego odpowiedź na pytanie co myśli o konwencjonalnym foie gras
I ciągle mówiłem, że wiesz, przysięgam na Boga, że ​​skosztowałem anyżu gwiazdkowatego.	And I kept I said you know I swear to God I tasted star anise.	Słowo daję że wyczułem anyż gwiaździsty.
Na przykład, jak zaczynaliśmy Ratan właśnie zaczynał z pięcioma młodymi ludźmi z zespołu inżynierów po dwudziestce.	For example how we started Ratan just began with a five engineer team young people in their mid twenties.	Na przykład jak zaczęliśmy Ratan właśnie zaczął z pięcioosobowym zespołem inżynierów młodych ludzi po dwudziestce.
Dlatego być może spróbujesz uzyskać ten kąt widzenia.	That is why perhaps you will try to have this angle of vision.	Dlatego właśnie może będziesz próbować przyjąć ten kąt widzenia.
A drugim wymiarem jest to, czy są tym, czym mówią, że są dla innych.	And the other dimension is are they what they say they are to others.	A drugi wymiar to kwestia tego czy są tym czym twierdzą że są wobec innych.
Nagle rozmowa i komunikacja z estrogenami i progesteronami, mówiącymi, że jestem tutaj, aby zostać, zasadzić mnie, budując ten niesamowity trójliniowy płód, który w ciągu 44 dni staje się czymś, co można rozpoznać, a po dziewięciu tygodniach jest naprawdę czymś w rodzaju małego człowieka.	All of a sudden having conversation and communications with the estrogens the progesterones saying I am here to stay plant me building this incredible trilinear fetus that becomes within 44 days something that you can recognize and then at nine weeks is really kind of a little human being.	Nagle porozumiewa się się z estrogenem i progesteronem Nagle porozumiewa się się z estrogenem i progesteronem mówiąc Zostaję zagnieźdźcie mnie . Formuje się niesamowity trójliniowy zarodek który po 44 dniach wygląda znajomo który po 44 dniach wygląda znajomo a w dziewiątym tygodniu naprawdę staje się małym człowiekiem.
Ale jesteśmy szaleni. Robimy takie rzeczy.	But we are crazy We do these things.	Ale my mamy fioła.
I wykonujemy tę pracę od 2000 roku i jest to bardzo ciężki projekt.	And we are doing this job since 2000 and it is a very heavy project.	Zaczęliśmy w roku 2000. To bardzo duży projekt.
Usługi telefoniczne na odległość, sprzedawane po cenie, restauracje fast food ze wszystkimi ich wartościami cenowymi, a nawet Internet komercjalizuje nie tylko towary, ale także usługi.	Long distance telephone service sold on price price price fast food restaurants with all their value pricing and even the Internet is commoditizing not just goods but services as well.	Długodystansowe połączenia sprzedawane za cenę cenę cenę Ceny w McDonalds oparte na wartości dla klienta. Także internet przekształca w towar nie tylko dobra ale i usługi.
Więc kiedy zaczynałem, nie miałem ogólnego planu dla maszyny, ale miałem wyczucie gestu i wyczucie kształtu i tego, jak zajmie miejsce.	So when I started this I didn not have an overall plan for the machine but I did have a sense of the gesture and a sense of the shape and how it would occupy space.	Kiedy więc zacząłem nie miałem ogólnego zamysłu maszyny jedynie poczucie gestu i kształtu oraz sposobu w jaki będzie zajmować przestrzeń.
Jeśli otrzymasz coś interesującego, to właśnie SETI robi to, co SETI robi od wielu lat.	If you receive something interesting well that is what SETI does actually what SETI has been doing for many years.	czekanie na interesującą transmisję. Tym zajmuje się SETI już od wielu lat.
Spójrz na tę małą kępkę naczyń włosowatych.	Take a look at this little tuft of capillaries.	a konkretnie małej kępce naczyń włosowatych.
Przed nami wielkie wyzwanie.	The big challenge in front of us.	Wielkie wyzwanie przed nami.
Cóż, dzieci na całym świecie są tym, co lubię nazywać obywatelami świata.	Well babies all over the world are what I like to describe as citizens of the world.	Dzieci na całym świecie są jak ja to lubię nazywać obywatelami świata .
Wszyscy używamy Wikipedii.	We all use Wikipedia.	Używamy Wikipedii.
A rozkład japońskiego jest zupełnie inny, gdy widzimy grupę dźwięków pośrednich, znaną jako japońskie R.	And the distribution of Japanese is totally different where we see a group of intermediate sounds which is known as the Japanese R.	Rozkład statystyczny japońskiego jest zupełnie inny widzimy grupę dźwięków pośrednich znaną jako japońskie R .
Chcę porozmawiać z tymi, którzy robią to od ponad dwóch lat.	And I want to talk to the ones of those that have been doing it for more than two years.	Chcę również porozmawiać z tymi którzy biorą je przez więcej niż 2 lata.
Każdy coś zrobił.	Everyone has done something.	Każdy coś robił.
Wstałem dziś rano o 6 10 rano.	I got up this morning at 6 10 am.	Wstałem dziś rano o 6 10 rano.
Jestem badaczem jakościowym.	I am a qualitative researcher.	Jestem naukowcem zajmującym się badaniami jakościowymi.
Niektóre z nich były dostępne, więc zatrudniliśmy jednego.	And some of them were available So we hired one.	Kilku z nich było dostępnych. Więc zatrudniliśmy jednego.
Wszystko szło źle.	Everything was going bad.	Wszystko stawało się gorsze.
Więc tak się stało, kiedy PNAS to opublikował.	So this is what happened when PNAS published this.	Oto co stało się gdy PNAS to opublikowało.
Wszystkie inne kraje, na przykład Wielka Brytania, mogą pożyczać pieniądze tylko na kwotę będącą w obiegu wewnątrz jej własnych granic.	All the other countries for example the United Kingdom can borrow only against the amount of money in circulation inside its own borders.	Pozostałe państwa na przykład Wielka Brytania mogą zaciągać pożyczki jedynie w stosunku do pieniądza który jest w obiegu wewnątrz ich granic.
Poszedłem więc do holu i zobaczyłem tego Hindusa.	So I went down to the lobby and I saw this Indian guy.	Schodzę do holu i widzę tego Hindusa.
Mam jeden gram pięć gramów 10 gramów. Ile gramów chcesz.	I have one gram five gram 10 gram How many gram do you want.	Mam gram pięć gram 10 gram ile gramów chcesz?
Na przykład fajne miejsce w Dubaju.	For example Dubai cool place.	Na przykład Dubaj świetne miejsce.
Wszystkie cztery moje wiosła pękły, zanim dotarłem do połowy.	All four of my oars broke before I reached halfway across.	Połamały się wszystkie moje wiosła zanim dotarłam do półmetka rejsu.
Spróbuj jogurtu Jest bardzo dobry Trochę drogi.	Try the yogurt It is very good Little expensive.	Spróbuj jogurtu. Bardzo dobry. Trochę drogi.
Pierwsza próba nie poszła tak dobrze.	The first attempt didn not go so well.	Pierwsze podejście nie poszło najlepiej.
Twój dziadek ma naruszenie zasad parkowania. Jest to spóźnione.	Your grandfather has a parking violation It is way overdue.	Twój dziadek ma mandat za parkowanie. Spore odsetki.
Innej rzeczy można się nauczyć, podróżując do tych krajów na Bliskim Wschodzie, czasami do krajów Ameryki Łacińskiej. Kraje Ameryki Południowej.	The other thing you learn sometimes when you travel to these countries in the Middle East sometimes in Latin American countries South American countries a lot of times when they build stuff there is no rules and regulations.	Inna rzecz którą można zauważyć gdy podróżuje się po Bliskim Wschodzie czasem w Ameryce Łacińskiej Ameryce Południowej często kiedy budują robią to bez reguł i zasad.
Długo przyszło po mnie.	It is been a long time in coming for me.	Czekałem na to bardzo długo.
Jeśli dziś esencjalizuję dla ciebie płeć, możesz odrzucić to, co mam do powiedzenia.	If I essentialize gender for you today then you can dismiss what I have to say.	Jeżeli przedstawię istotę płci dzisiaj możecie odrzucić to co powiem.
Co jest również interesujące, jeśli spojrzysz na produkty, które mają wysoki składnik tego, co możesz nazwać wartością komunikacyjną, wysoki składnik wartości niematerialnej w porównaniu z ich wartością wewnętrzną. Często są one dość egalitarne.	What is also interesting if you look at products that have a high component of what you might call messaging value a high component of intangible value versus their intrinsic value They are often quite egalitarian.	Co ciekawe jeśli spojrzy się na produkty które mają wysoką zawartość tego co można by nazwać wartością przesłania wysoką zawartość wartości niematerialnej w przeciwieństwie do ich zasadniczej wartości są one często dość egalitarne.
Mam nadzieję, że każdy z was poświęci chwilę na zastanowienie się, jak można użyć czegoś takiego, aby zapewnić sobie większy dostęp do własnego świata i uczynić własne podróże wygodniejszymi i przyjemniejszymi.	I hope you will each take a moment to think about how you could use something like this to give yourself more access to your own world and to make your own travel more convenient and more fun.	Mam nadzieję że każdy z was pomyśli jak mógłby wykorzystać coś takiego aby poprawić sobie dostęp do własnego świata i uczynić podróżowanie bardziej wygodnym i przyjemniejszym.
Został wykonany z żeliwa.	It was made of cast iron.	a ta wykonana z żeliwa.
Moja alma mater MIT i ja przeżyliśmy ten moment w rodzaju M Night Shayamalan, w którym pomyślałem, że muszę to zrobić.	My alma mater MIT and I had this moment a kind of M Night Shayamalan moment where I thought Whoa I have to do this.	Przeżyłem taki dziwny moment w związki z moją alma mater MIT coś jak wizja M. Night. Shayamalana kiedy pomyślałem Muszę to zrobić! coś jak wizja M. Night. Shayamalana kiedy pomyślałem Muszę to zrobić! .
Na 100 dziewcząt uczęszczających do szkół specjalnych przypada 217 chłopców.	For every 100 girls in special education there are 217 boys.	Na każde 100 dziewczyn objętych specjalną edukacją przypada 217 chłopców.
Każdy kraj ma kontekstowy napój alkoholowy. We Francji jest to Pernod.	Every country has a contextual alcoholic drink In France it is Pernod.	każdy kraj ma swój kontekstowy napój alkoholowy. We Francji to Pernod.
Obecnie marketing wykonał bardzo dobrą robotę, stwarzając okazje do zakupów pod wpływem impulsu.	Now marketing has done a very very good job of creating opportunities for impulse buying.	Wielka zasługa marketingu polega na tym że stworzył możliwości do impulsywnego kupowania.
Skutecznie zrobiłby to, że zmieniłby oznakowanie ziemniaka.	What he would effectively done is he would re branded the potato.	To czego efektywnie dokonał to zmiana marki ziemniaka.
A to, co dodamy na wierzchu, jest trochę fałszywe. To jest fałszywa wersja.	And that what we add on top is kind of false It is a fake version.	A to co dokładamy do tego jest w pewnym sensie fałszywe. To podróbka.
Ludzie uważają to za dziwne, ale myślę, że było to dla nas wielkie błogosławieństwo.	People find that strange but I think it was a great blessing for us.	Ludzie myślą że to dziwne ale ja twierdzę że to było dla nas błogosławieństwo.
Po trzęsieniu zaczęliśmy sprowadzać inżynierów zajmujących się trzęsieniem ziemi, aby dowiedzieć się, dlaczego zawaliły się budynki i zbadać, co było bezpieczne, a co nie.	And after the quake we started bringing in earthquake engineers to figure out why the buildings collapsed to examine what was safe and what wasn not.	Po trzęsieniu zaczeliśmy sprowadzać specjalistów od trzęsień ziemii by ustalili dlaczego budynki się zawaliły by zbadali co jest a co nie jest bezpieczne.
OK, więc jeśli weźmiemy to równanie, dlaczego nie słyszeliśmy od nikogo.	OK so if we take that equation why haven not we heard from anybody out there.	OK w takim razie skoro przyjmujemy to równanie dlaczego nie dostaliśmy wiadomości od nikogo stamtąd?
Dorastaliśmy bez telewizora.	We grew up without a television.	Wychowaliśmy się bez telewizji.
Ale że zostanie skopiowany, jeśli to możliwe, bez względu na konsekwencje.	But that it will get copied if it can regardless of the consequences.	Ale że zostanie skopiowany jeśli będzie mógł niezależnie od konsekwencji.
Aby dać ci wyobrażenie o skali, instalacja ma około sześciu stóp szerokości, a najwyższe modele mają około dwóch lub trzech stóp wysokości.	Just to give you an idea of scale that installation there is about six feet across and the tallest models are about two or three feet high.	Abyście mieli pojęcie o rozmiarze ta instalacja jest szeroka na ok. dwa metry. Najwyższe z modeli sięgają 60 90cm.
Byłem nominowany do nagrody Grammy i zdobyłem kilka nagród i tego typu rzeczy, więc to jest niesamowite, ale najlepsze było spotkanie z mężem i właściwie znam Donnella od prawdopodobnie 12 lat i zamierzam się trochę zagłębić w Wydaje mi się, że muzyka nas połączyła, ale teraz przedstawię wam mojego nowego męża, Donnella Leahy'ego, 5 października.	I was nominated for a Grammy and I have won some awards and stuff like that so that is awesome but the best part was meeting my husband and I have actually known Donnell for probably 12 years now and I am going to get into a little bit of I guess how music brought us together but I am going to introduce you right now to my new husband as of October 5 Donnell Leahy.	Otrzymałam nominację do Grammy oraz zdobyłam kilka nagród i wyróżnień i to jest wspaniałe ale najlepszym epizodem było poznanie mojego męża właściwie wtedy znałam go już od około 12 lat ale opowiem troszeczkę o tym jak zbliżyła nas muzyka. Przedstawiam wam mojego męża jest nim od 5 października Donnell Leahy.
Cóż, mówię tak, a jeśli tak, to daję nagrodę Darwinowi.	Well I say yes and if there is I give the prize to Darwin.	Cóż ja mówię tak i przyznaję za taką ideę nagrodę Darwinowi.
Publiczność musi.	Audience Must.	Publiczność Musimy”.
Darwin wpadł na niesamowity pomysł.	Darwin had this amazing idea.	Darwin miał taką zadziwiającą ideę.
Mogę tego dotknąć, mogę się tym bawić.	I can touch it I can play with it.	Mogę ją dotknąć. Mogę się nią pobawić .
Możesz zagłębić się według określonego rodzaju wydatków lub możesz przejść przez wszystkie różne regiony i porównać je.	You can burrow down by a particular type of spending or you can go through all the different regions and compare them.	Można sprawdzić według rodzaju wydatków albo porównać różne części kraju.
Ponieważ wierzymy, że to nie biologia, to kultura.	Because we believe that it is not biology it is culture.	Bo wierzymy że nie chodzi tu o biologię tylko o kulturę.
I wszyscy znacie odpowiedź Czy ktoś chce to wykrzyczeć.	And you all know the answer Does someone want to shout it out.	Wszyscy znacie odpowiedź. Może ktoś ją wykrzyknie?
Na tym schemacie znajdujemy się w połowie drogi.	On that schematic picture a sort of time lapse picture we are halfway.	Na tym ponadczasowym schemacie jesteśmy w połowie drogi.
Krzywa jest bardzo podobna do leksygramu.	The curved line is very similar to the lexigram.	Ta falista linia bardzo przypomina leksygram.
Dlatego udostępniamy narzędzia, technologię i język. Dziękujemy.	So we are sharing tools and technology and language Thank you.	A więc dzielimy się narzędziami technologią i językiem z innym gatunkiem. Dziękuję.
I uzyskał z innych źródeł danych informacje, aby pokazać, w których domach mieszkają biali ludzie.	And he got from other data sources information to show which houses are occupied by white people.	A z innych źródeł uzyskał informacje o tym w których domach mieszkają biali amerykanie.
Gwiazdy w tych galaktykach prawdopodobnie nie mają wokół siebie planet.	The stars in those galaxies probably don not have planets around them.	Gwiazdy tych galaktyk prawdopodobnie nie posiadają planet.
Teraz możemy ich znowu ścigać. Idź po nie.	Now we can chase them again Go get them.	Teraz znów możemy je gonić. Łap je!
Dopóki badania nie zostaną ponownie przeprowadzone z udziałem dzieci adopcyjnych, które zapewniają swoim dzieciom środowisko, ale nie zapewniają genów, nie mamy możliwości dowiedzenia się, czy te wnioski są słuszne.	Until the studies are redone with adoptive children who provide an environment but not genes to their kids we have no way of knowing whether these conclusions are valid.	Dopóki badania nie zostaną przeprowadzone na adoptowanych dzieciach na które wpływ ma tylko otoczenie a nie związane z tym otoczeniem geny nie mamy podstaw do uznania wspomnianych badań za wiarygodne.
Pod każdym względem ekonomicznym popyt na sztukę we wszystkich formach gwałtownie rośnie, co można stwierdzić z ceny biletów do opery, liczby sprzedanych książek, liczby wydanych książek, liczby wydanych tytułów muzycznych, liczby nowych albumów i tak dalej.	By any economic standard the demand for art of all forms is skyrocketing as you can tell from the price of opera tickets by the number of books sold by the number of books published the number of musical titles released the number of new albums and so on.	Pod każdym ekonomicznym względem zapotrzebowanie na sztukę w każdej formie jest kosmiczne. Co możemy stwierdzić po cenach biletów operowych ilości publikowanych oraz sprzedawanych książek liczby nowych utworów muzycznych nowych albumów i tak dalej.
I bardzo szybko coś, nad czym pracowaliśmy od niedawna, to powierzenie nam przez burmistrza Londynu zaprojektowania nowego autobusu, który ponownie zapewni pasażerom wolność.	And just very quickly something we have been working on very recently is we were commissioned by the mayor of London to design a new bus that gave the passenger their freedom again.	I tak bardzo szybko coś nad czym pracowaliśmy bardzo niedawno otrzymaliśmy zlecenie od burmistrza Londynu by zaprojektować nowy autobus który dałby pasażerowi jego wolność jak kiedyś.
A oto, co się stanie, jeśli trafisz na parę ludzi, którzy mają wspólne DNA, a mianowicie klony lub identyczne bliźnięta.	And here is what happens if you get a pair of people who share all their DNA namely clones or identical twins.	A tu z kolei widzimy co się stanie gdy zbadamy dwójkę ludzi dzielących cały swój DNA czyli klony lub bliźnięta jednojajowe.
Kiedy po raz pierwszy usłyszałem ten temat, pomyślałem, że dobrze ogarnąć inność jest ogarnąć siebie.	When I first heard this theme I thought well embracing otherness is embracing myself.	Gdy pierwszy raz usłyszałam to pojęcie pomyślałam cóż to ogarnąć siebie.
Hydroizolacja budynku była trochę szalona.	Waterproofing the building was a bit crazy.	Uszczelnianie budynku przed wodą było trochę zwariowane.
To bardziej rzeczywistość niż ta, którą stworzyliśmy sami.	It is more a reality than the ones our selves have created.	Jest to bardziej rzeczywiste niż te ja  które sami wytworzyliśmy.
Po pierwsze wszyscy są świadomi swoich najbliższych sąsiadów.	First all the individuals are only aware of their nearest neighbors.	Po pierwsze wszystkie osobniki widzą tylko swoich najbliższych sąsiadów.
Nadal wierzyłem, że jestem sobą.	I still believed my self was all I was.	wierzyłam że moje ja  to wszystko czym jestem.
Punktem wyjścia do tej dyskusji był fakt, że wszyscy podlegaliśmy radom macierzystego kompleksu przemysłowego.	And the starting point is the for that discussion was the fact that we have all been subject to the advice of the parenting industrial complex.	Rozpocznijmy od faktu że każdy z nas był celem wielkiej machiny doradztwa rodzicielskiego.
Więc robię teraz coś, czego nigdy nie robiłem na zdjęciach Dirty Jobs.	So I do something now I have never ever done on a Dirty Jobs shoot ever.	Po raz pierwszy w historii Brudnej roboty .
Cóż, przede wszystkim, co będzie dalej.	Well first of all what is going to happen next.	Po pierwsze co będzie się działo potem?
Prawdopodobnie najgorsza rada, jaką kiedykolwiek otrzymałem.	Probably the worst advice I ever got.	Ano to najgorsza rada jaką w życiu dostałem.
Ale teraz, gdy zimna wojna dobiegła końca, w świecie muzułmańskim panuje niemal powszechny konsensus i prawie taki sam w Stanach Zjednoczonych, jeśli rozmawiasz z ludźmi i pytasz ich, że w zasadzie nie ma powodu, dla którego demokracja i islam nie mogą współistnieć. .	But now that the Cold War is over there is nearly universal consensus in the Muslim world and pretty close to the same here in the United States if you talk to people and ask them that in principle there is no reason that democracy and Islam cannot co exist.	Ale teraz kiedy zimna wojna się skończyła istnieje niemalże powszechna zgoda w muzułmańskim świecie – podobnie jak tu w Stanach jeśli zapytasz ludzi – że w zasadzie nie ma powodu aby demokracja i islam nie mogły współistnieć.
Jestem praktykantem i pracuję z ludźmi, którzy faktycznie wykonują dane prace.	I am an apprentice and I work with the people who actually do the jobs in question.	Jestem uczniem i pracuję z ludźmi danej profesji.
Yossi Vardi walczy z lokalnym ociepleniem.	Yossi Vardi fights local warming.	Yossi Vardi walczy z lokalnym ociepleniem.
Stworzyłem teorię i zamierzam się nią teraz podzielić przez pozostałe dwie minuty i 30 sekund.	I formed a theory and I am going to share it now in my remaining two minutes and 30 seconds.	Sformułowałem teorię którą teraz się podzielę przez ostatnie 2 minuty i 30 sekund.
Z drugiej strony istnieje dalsza możliwość, że wielu Amerykanów ogarniętych gorączką wojny powie, poczuje i pomyśli, że islam jest w jakiś sposób wrogiem, że islam powinien być rozumiany jako wróg.	On the other hand there is a further possibility that many Americans swept up in the fever of a war will say and feel and think that Islam is the enemy somehow that Islam ought to be construed as the enemy.	Z drugiej strony istnieje też możliwość że wielu Amerykanów dotkniętych wojenną zawieruchą powie poczuje i pomyśli że islam jest w jakiś sposób wrogiem – że musiał być skonstruowany jako wróg.
Ale mam nadzieję, że wyjdziesz na zewnątrz i zobaczysz świat w nowy sposób, aby zobaczyć całą niesamowitą synchronizację wokół nas. Dziękuję.	But I hope that you will go outside and see the world in a new way to see all the amazing synchrony around us Thank you.	Ale mam nadzieję że po wyjściu zobaczycie świat na nowo z otaczającą nas niezwykłą synchronią. Dziękuję.
Jako grupa są najszczęśliwszymi ludźmi, jakich znam.	As a group they are the happiest people I know.	Nie ma od nich szczęśliwszej grupy.
I dowiedziałem się, że jedna osoba może zrobić ogromną różnicę.	And I learned that one person can make a huge difference.	I że jedna osoba może bardzo dużo zmienić.
Więc zaczynamy.	So here we go.	No to zaczynamy.
Jest to gra, w którą grasz z innymi ludźmi.	And it is a game you play with other people.	Gra się z innymi ludźmi.
Zgadnij, co to się zmienia.	Well guess what That is changing.	Ale to się zmienia.
Jest tylko jedno rozwiązanie. Nie jest to takie trudne.	There is only one solution It is not that hard.	Jest tylko jedno rozwiązanie.
Ale bardzo podoba mi się sposób, w jaki jest pozowany.	But I quite love the way it is posed.	Uwielbiam jej ułożenie.
Wtedy nie mogą stać się większe, ponieważ nie mają dopływu krwi, więc nie mają wystarczającej ilości tlenu lub składników odżywczych.	Then they can not get any larger because they don not have a blood supply so they don not have enough oxygen or nutrients.	Nie mogą urosnąć większe bo nie są zaopatrywane w krew więc nie mają wystarczająco dużo tlenu i składników odżywczych.
Statyny to niesteroidowe leki przeciwzapalne i kilka innych, które również hamują angiogenezę.	Statins nonsteroidal anti inflammatory drugs and a few others they inhibit angiogenesis too.	Statyny niesteroidowe leki przeciwzapalne i kilka innych które także hamują angiogenezę.
I myślę, że tego teraz świat potrzebuje. Dziękuję.	And that is what I think the world needs now Thank you.	I to jest to czego świat teraz potrzebuje. Dziękuję.
Nasze poszukiwania zaprowadziły nas na rynek, do farmy i do sklepu z przyprawami, ponieważ odkryliśmy, że matka natura połączyła dużą liczbę pokarmów, napojów i ziół z naturalnie występującymi inhibitorami angiogenezy.	Our search for this has taken us to the market the farm and to the spice cabinet because what we have discovered is that mother nature has laced a large number of foods and beverages and herbs with naturally occurring inhibitors of angiogenesis.	Nasze poszukiwania zabrały nas na rynek na farmę i do szafki z przyprawami ponieważ odkryliśmy że matka natura przygotowała wielką liczbę pokarmów napojów i ziół z naturalnie występującymi inhibitorami angiogenezy.
Ale to, co mi się przydarzyło, to fakt, że to rozbicie naprawdę ośmieliło mnie w sposób, w jaki nigdy nie byłem ośmielony.	But what happened for me is that that shattering actually emboldened me in a way I have never been emboldened.	Ale to co się wydarzyło we mnie to zdruzgotanie w rzeczywistości dodało mi odwagi jak nigdy wcześniej.
A zdjęcie rentgenowskie pokazuje, jak piękna może być natura.	And the X ray shows how beautiful nature can be.	Widać jak piękna może być natura.
I myślę, że nauczyliśmy ludzi, aby byli bezpieczni, kiedy czują się niepewnie, aby udawać, że wiedzą, kiedy nic nie wiedzą lub dlaczego mielibyśmy być tam, gdzie jesteśmy.	And I think we have taught men to be secure when they are insecure to pretend they know things when they don not know things or why would we be where we are.	Myślę że nauczyliśmy mężczyzn żeby byli pewni siebie kiedy nie są żeby udawali że wiedzą kiedy naprawdę nie mają pojęcia bo jak inaczej doszlibyśmy do punktu w którym jesteśmy?
Myślę, że cały świat został zasadniczo wychowany, by nie być dziewczyną.	I think the whole world has essentially been brought up not to be a girl.	Myślę że generalnie cały świat został wychowany tak żeby nie być dziewczynką.
Jego ciało jest w więzieniu, ale jego umysł jest wolny.	His body is in prison but his mind is free.	Ciałem jest w więzieniu ale umysłem na wolności.
A przynajmniej tak mówisz, kiedy się identyfikujesz.	Or at least that is what you say when you identify yourself.	Przynajmniej tak się mówi gdy trzeba się zdefiniować.
Powiedzieli jej, że nie może kochać swojej pochwy w liceum, że nie jest to prawnie, że nie jest rzeczą moralną, że nie jest to dobra rzecz.	They told her she couldn not love her vagina in high school that it was not a legal thing that it was not a moral thing that it was not a good thing.	Powiedzieli jej że w liceum nie może kochać swojej waginy że to nie jest legalne ani moralne i że to nie jest dobre.
Dziękuję Ci bardzo.	Thank you very much.	Bardzo wam dziękuję.
Tak więc natura ma podobną strukturę.	So nature has this self similar structure.	Tę samopodobną strukturę ma przyroda.
Wszyscy w całości nadaje się do recyklingu.	We are all totally recyclable.	Pochodzimy z odzysku i zostaniemy przetworzeni.
Wchodzimy w interakcję z naszą rozrywką.	We are interacting with our entertainment.	Przeprowadzamy interakcję z naszą rozrywką.
Uczeń 2 Co dostałeś Co dostałeś.	Student 2 What did you get What did you get.	Naucz. I co wyszło?
Teraz wiem, że było dużo szumu na temat naszej mocy kontrolowania biologii.	Now I know there is been a whole lot of hype about our power to control biology.	Wiem że było mnóstwo szumu na temat możliwości kontrolowania biologii.
I pokażę wam może do 2007 roku.	And I am going to show you up to maybe 2007.	Pokażę wam jej postęp do roku 2007.
Chociaż niektóre z tych instynktów mogą być wrodzone, większość z nich jest wyuczona i wszystkie są wbudowane w nasz mózg.	While some of these instincts may be innate most are learned and all of them are hardwired into our brains.	Niektóre z tych instynktów są wrodzone inne zaś nabyte wszystkie są wplecione w nasze mózgi.
Jeśli wątpię, czy moja starsza siostra jest w stanie spłacić 10-procentowe odsetki, które ustaliłem od jej ostatniej pożyczki, wstrzymam jej możliwość uzyskania ode mnie większej ilości pieniędzy, dopóki ich nie spłaci.	If I doubt my older sister is ability to pay back the 10 percent interest I established on her last loan I am going to withhold her ability to get more money from me until she pays it back.	Jeżeli mam wątpliwości czy moja siostra będzie w stanie zapłacić 10 procentowe odsetki które nałożyłam na jej ostatnią pożyczkę to przestanę jej pożyczać pieniądze do momentu aż wszystko spłaci.
Jeśli zacznę tutaj tę małą grę, którą zrobiły dzieci, rozbije ona statek kosmiczny.	If I start the little game here that the kids have done it will crash the space ship.	Jeśli tak zrobię gra zrobiona przez dzieci pokazuje że rakieta spadnie.
Najodważniejsi są z pewnością ci, którzy mają najlepszą wizję tego, co jest przed nimi zarówno w chwale, jak i niebezpieczeństwie.	The bravest are surely those who have the clearest vision of what is before them both glory and danger alike.	Najodważniejsi to ludzie którzy widzą jasno co przed nimi stoi zarówno chwałę jak i niebezpieczeństwa.
Ale nie powinniśmy się oszukiwać i myśleć, że osiągniemy konsensus w tych sprawach.	But we shouldn not kid ourselves and think that we are going to reach a consensus about these things.	Ale nie oszukujmy się nie uda nam się osiągnąć zgody w tych tematach.
A co by było, gdybyśmy mogli rozwikłać proces starzenia się i zrozumieć, że zaczyna on opóźniać proces, a nawet go odwracać.	What if we could unravel aging and understand it begin to retard the process or even reverse it.	Co będzie jeśli rozwiążemy zagadkę starzenia się nauczymy się spowalniać lub nawet odwracać ten proces?
I niestety na YouTube jest wiele filmów z krycia kotów.	And unfortunately on YouTube there is many cats mating videos.	I niestety na Youtube ie jest sporo filmów z parzącymi się kotami.
Kształtują nasze pragnienia.	They are shaping our very desires.	Określają nasze pragnienia.
Oto plan niedrogiego chłodzenia, które nie wykorzystuje energii elektrycznej, propanu, nafty ani materiałów eksploatacyjnych.	So here is the plan inexpensive refrigeration that doesn not use electricity propane gas kerosene or consumables.	 oto plan niedroga chłodziarka która nie potrzebuje elektryczności   propanu gazu nafty itp. .
A dla dyktatorów na całym świecie dobrą wiadomością jest to, że dziennikarze rysowników i aktywiści się zamykają.	And for dictators all over the world the good news is when cartoonists journalists and activists shut up.	I dla wszystkich dyktatorów dookoła świata dobrą wiadomością będzie kiedy rysownicy dziennikarze i aktywiści zamkną się.
Czytałeś już o tym.	You have read about it already.	Czytaliście już o tym.
Taka była wiadomość. To był eksperyment.	That was the message That was the experiment.	Taki był przekaz tego eksperymentu.
Ponieważ w opiece zdrowotnej większość opieki zdrowotnej dane są bardzo usunięte z działania.	Because in health care most health care the data is very removed from the action.	Ponieważ w większej części opieki zdrowotnej informacja jest zupełnie odseparowana od działania.
Mój brat jest trochę zajęty.	My brother is kind of busy.	Mój brat był trochę zajęty .
A jeśli to rozwalisz i powiększysz 900 razy, zobaczysz, że są tam włoski, maleńkie włosy. A jeśli przyjrzysz się uważnie, te małe włoski mają prążki. A jeśli powiększysz te 30000 razy, zobaczysz, że każdy włos ma rozdwojone końcówki.	And if you blow that up and zoom in 900 times you see there are hairs there tiny hairs And if you look carefully those tiny hairs have striations And if you zoom in on those 30000 times you will see each hair has split ends.	A po kolejnym 900 krotnym powiększeniu ujrzycie tam włoski a jeśli spojrzycie uważnie  te włoski też mają prążki. Zbliżając je 30000 razy zauważycie że włosy mają rozłożyste końcówki.
Chcieli uchwycić jeszcze jedną zmienną, jaką było poczucie skuteczności pacjentów.	They wanted to capture one other variable which was the patients' sense of efficacy.	Chcieli uchwycić inna zmienną która było poczucie celu.
Odbiorcy To ludzie logujący się do Google na całym świecie.	Audience It is people logging on to Google around the world.	Widownia Użytkownicy Google a w różnych częściach świata.
Więc naprawdę podejrzewam, że istnieje alternatywa i że życie tak naprawdę stara się działać nie świadomie, ale tylko dlatego, że tak jest.	So I really suspect there is an alternative and that life does actually try to do itself in not consciously but just because it does.	Naprawdę podejrzewam inne wyjaśnienie że życie próbuje się unicestwić nieświadomie ale jednak.
Świadomość.	Well consciousness.	Cóż świadomość.
Są to informacje, które są niezwykle potężne.	This is information that is incredibly powerful.	Są to informacje niezwykłej wagi.
To jest Mark Roth Został ufundowany przez DARPA.	This is Mark Roth He was funded by DARPA.	To Mark Roth finansowany przez DARPA.
Więc to niefortunne.	So that is unfortunate.	To smutne.
Teraz chciałbym tylko pokazać, jak wyglądałaby jedna sekunda tego ćwiczenia.	Now what I would like to do is just to show you what one second of this activity would look like.	Chcę wam tu pokazać jak wygląda jedna sekunda.
Siergiej wspomniał o Orkucie, o czym wiesz, że Orkut chciał robić w swoim czasie i nazywamy to w Google. Uosabialiśmy to jako 20% czasu, a pomysł jest taki, że 20% twojego czasu, jeśli pracujesz w Google, możesz rób to, co uważasz za najlepsze.	And Sergey mentioned Orkut which is something that you know Orkut wanted to do in his time and we call this at Google we have embodied this as the 20 percent time and the idea is for 20 percent of your time if you are working at Google you can do what you think is the best thing to do.	Sergiej wspominał o Orkucie który chciał się zająć czymś co go pasjonowało. To przykład tego co określamy tu w Google u jako 20 procent normy . Chodzi o to że pracownicy 20% swojego czasu mogą poświęcać na projekty którymi sami chcą się zajmować.
Przez jakiś czas też mieliśmy ten problem i powiedzieliśmy, że naprawdę potrzebujemy nowej koncepcji.	And we had this problem too for a while and we said Oh we really need a new concept.	W którymś momencie sami tego doświadczyliśmy. Pomyśleliśmy „Potrzebna jest nowa koncepcja”.
Ponieważ możesz wpisać w Google, że wiesz, jakąkolwiek rzecz, i oczekujesz właściwej odpowiedzi.	Because you can type you know any kind of thing into Google and you expect an answer back right.	Wprowadzacie do wyszukiwarki cokolwiek przyjdzie wam do głowy i oczekujecie że Google dostarczy odpowiedzi tak?
Biedni ludzie, których prawa człowieka zostały naruszone, sednem tego jest utrata godności, brak godności.	Poor people people whose human rights have been violated the crux of that is the loss of dignity the lack of dignity.	Biedni ludzie ludzie których prawa człowieka zostały naruszone brzemię tego to strata godności. Brak godności.
Rozumiem, powiedziałem, że Japończycy nie dodają cukru do swojej zielonej herbaty, ale chciałbym dodać trochę cukru do mojej zielonej herbaty.	I understand I said that the Japanese do not put sugar in their green tea but I would like to put some sugar in my green tea.	Zdaję sobie sprawę powiedziałam z tego że Japończycy nie słodzą zielonej herbaty. Ale ja chciałabym trochę cukru w mojej herbacie.
Zanim napisał swój trzeci raport, przyznał się, że zawiódł i zamiast tego stworzył społeczeństwo konsumentów korzystających z opieki społecznej.	By the time he wrote his third report he confessed that he had failed and instead had created a society of welfare consumers.	Gdy opublikował trzeci raport przyznał się do porażki do stworzenia społeczeństwa konsumentów opieki społecznej.
Powiesz, jak możemy im ufać.	You will say How can we trust them.	Powiecie Jak możemy im ufać?
Gdybyśmy nazwali Valedictorian białym rycerzem paladynem na poziomie 20, myślę, że ludzie prawdopodobnie pracowaliby dużo ciężej.	If we called valedictorian a white knight paladin level 20 I think people would probably work a lot harder.	Gdybyśmy Najlepszego Absolwenta nazwali Rycerzem Światła Paladynem na poziomie 20 pewnie wszyscy by się bardziej przykładali do nauki.
Wiem, że jestem niesamowicie zdenerwowany i podekscytowany, że jestem tutaj na górze, co bardzo utrudnia mi utrzymanie spokoju.	I know that I am incredibly nervous and excited to be up here which is greatly inhibiting my ability to keep it cool.	Wiem że jestem niesamowicie podekscytowana swoją obecnością tutaj co uniemożliwia mi zachowanie spokoju.
Wkrótce doszło do długiej dyskusji i w końcu podszedł do mnie menadżer i powiedział, że bardzo mi przykro. Nie mamy cukru.	Pretty soon a lengthy discussion ensued and finally the manager came over to me and said I am very sorry We do not have sugar.	Bardzo szybko wywiązała się długa dyskusja aż w końcu kierownik podszedł do mojego stolika i powiedział Bardzo mi przykro ale nie mamy cukru.
Powiedzieli, że ludzie, którzy nas zatrudniają, traktują nas tak, jakbyśmy byli mniej niż ludzie, jakbyśmy nie istnieli.	They said The people who employ us treat us like we are less than human like we don not exist.	Powiedzieli Ludzie którzy nas zatrudniają traktują nas jakbyśmy nie byli ludźmi jakbyśmy nie istnieli.
Ludzie muszą czasem wybierać dla siebie, trzymając się swojej broni, niezależnie od tego, czego chcą lub zalecają inni ludzie.	People must choose for themselves sometimes sticking to their guns regardless of what other people want or recommend.	Ludzie sami dokonują wyboru często obstając przy swoim bez względu na życzenia lub rady innych.
I widzieliśmy w kółko, w jaki sposób poezja mówionego słowa otwiera zamki.	And we saw over and over the way that spoken word poetry cracks open locks.	I za każdym razem obserwowaliśmy jak poezja mówiona otwiera zamknięte drzwi.
Jak zacząłem w tym biznesie.	How did I get started in this business.	Jak zaczynałem w tym biznesie?
To wspaniała historia i jest zrozumiałe, dlaczego niechętnie by ją poprawiali.	It is a great story and it is understandable why they would be reluctant to revise it.	To świetna opowieść więc nic dziwnego że jesteśmy tacy niechętni aby ją zrewidować.
Ale jeśli chodzi o tę część historii, chciałbym rzucić to do Ameryki, mówi wiodący korespondent technologiczny John Markoff.	But for this part of the story I would actually like to throw it to America is leading technology correspondent John Markoff.	Ale tą część opowieści przekażę korespondentowi technologicznemu Johnowi Markoffowi.
Codziennie chodzę do pracy lub jeżdżę na skuterze i schodzę na dół i parkuję w tym małym miejscu.	I walk to work every day or ride my scooter and I come down and park in this little spot.	Chodzę codziennie do pracy albo jeżdżę skuterem dojeżdżam i parkuję o tu.
I myślę, że to jest powód, dla którego telewizja jest tak trudna.	And I think it is the reason that TV is so challenged.	dlatego telewizja jest takim wyzwaniem.
Jesteśmy teraz na etapie trzecim na etapie alarmu pandemicznego z niewielkim przenoszeniem się z człowieka na człowieka, ale bez trwałego przenoszenia z człowieka na człowieka.	We are now at stage three on the pandemic alert stage with just a little bit of human to human transmission but no human to human to human sustained transmission.	Obecnie jesteśmy w stopniu trzecim alarmu pandemii z niewielkim przenoszeniem się między ludźmi ale bez nieustannego przenoszenia się między ludźmi.
Ptasia grypa Stoję tutaj jako reprezentant wszystkich okropnych rzeczy, to może być najgorsze.	Bird flu I stand here as a representative of all terrible things this might be the worst.	Ptasia grypa. Jestem przedstawicielem wszystkich strasznych zjawisk a to może być najgorsze.
Zdecydowanie najprostszą metodą jest zakup gotowego dysku wideo i stosów HyperCard od dostawcy komercyjnego.	By far the simplest method is to buy a pre made videodisc and HyperCard stacks from a commercial supplier.	Ale najprostszą jest kupienie gotowego dysku wideo oraz stosu HyperCard od komercyjnego dostawcy.
Jednak każdy blednie do znikomego znaczenia wraz z ukończeniem tego wspaniałego osiągnięcia technologii XXI wieku, cyfrowej superszybkiej autostrady.	Yet each pales to insignificance with the completion of that magnificent accomplishment of twenty first century technology the Digital Superhighway.	Znaczenie każdego blednie przy wielkim osiągnięciu technologii XXI wieku Autostrady Cyfrowej.
Jak mnie do tego zmusili.	How did they get me to do that.	Jak mogli mnie do tego nakłonić?
Czytałem Sartre'a i Sokratesa.	I read Sartre and Socrates.	Czytałam Sartre a i Sokratesa
Ups, przepraszam, co się działo.	Oops I am sorry What was going on.	Ups przepraszam. Co się stało?
może naprawdę przyjąć rolę lidera, a Chicago jest jednym z przykładów.	can really take a leadership role and Chicago is one example.	mogą rzeczywiście przyjąć rolę lidera a Chicago jest tego przykładem.
Ma to swoje wady.	There are drawbacks to this.	Są wady tego rozwiązania.
Czy możesz nam powiedzieć, co ujawniłeś i co się stało.	Can you tell us what you leaked and what happened.	Czy możesz powiedzieć nam co ujawniłeś i co się stało?
Mam na myśli to, że istnieje metoda, którą można zastosować do różnych rzeczy.	I mean there is like there is a method that can be deployed for various things.	Jest coś jest metoda która może być stosowana do wielu rzeczy.
Jeśli uda nam się mieć ten dokument.	If we can have this document up.	Jeśli mogę prosić o ten dokument .
To dwoje ludzi porzucających udawanie, że wiedzą wszystko.	It is two people dropping the pretense of being know it alls.	To dwoje ludzie którzy wyzbywają się pretensji do bycia wszechwiedzącymi.
A kiedy Kibaki doszedł do władzy poprzez koalicję sił, które próbowały oczyścić z korupcji w Kenii, zlecili ten raport, wydali około dwóch milionów funtów na ten i powiązany raport.	And when Kibaki got into power through a coalition of forces that were trying to clean up corruption in Kenya they commissioned this report spent about two million pounds on this and an associated report.	I kiedy Kibaki doszedł do władzy poprzez koalicję sił które próbowały uprzątnąć korupcję w Kenii zlecono wykonanie tego raportu który wraz z jeszcze jednym powiązanym raportem kosztował około 2 milionów funtów.
Pewnego dnia młody człowiek spojrzał mi przez ramię i powiedział, że bardzo dobrze rysujesz.	One day a young man looked over my shoulder he said You draw very well.	Kolega za mną podglądnął mój rysunek i powiedział Dobrze rysujesz.
W miarę, że masz kod i miarę, którą go przeczytałeś, i tak przy okazji, jak odczytano pierwszą roślinę dwa lata temu, pierwszego człowieka odczytano dwa lata temu, pierwszego owada odczytano dwa lata temu.	In the measure that you have the code and the measure that you read it and by the way the first plant was read two years ago the first human was read two years ago the first insect was read two years ago.	Jeśli mamy już kod i umiemy go odczytać Pierwsza roślina została odczytana dwa lata temu pierwszy człowiek i owad też dwa lata temu.
Dzięki niektórym z najgorętszych tematów mikroblogowania możemy zobaczyć, na czym najbardziej zależy młodym ludziom.	So through some of the hottest topics on microblogging we can see what young people care most about.	Poprzez najgorętsze tematy na mikroblogach możemy zauważyć czym młodzi ludzie przejmują się najbardziej.
Następnie porównuję swoje informacje z tym, co znajduję w Internecie, na zdjęciach satelitarnych, danych pogodowych ze stacji meteorologicznych oraz morskich boi.	I then compare my information to the things I find on the Internet satellite images weather data from weather stations as well as offshore buoys.	Porównuję informacje do tych znalezionych w Internecie zdjęć satelitarnych danych ze stacji meteorologicznych i z przybrzeżnych boi.
Dlatego tam byłem, chciałem zaprosić ich do oglądania i odkrywania.	That is why I was there I wanted to invite them to look and explore.	żeby dzieci mogły same zbadać sprawę.
I to wszystko pochodzi z rzeczy, które wyglądają tak.	And it is all coming out of things that look like this.	A to wszystko pochodzi z czegoś takiego.
Ponieważ we WSZYSTKICH białaczkach ten zestaw genów ulega ekspresji.	Because in ALL leukemia that set of genes over there over expresses.	We WSZYSTKICH odmianach białaczki ten zestaw genów powoduje nadekspresję.
Ale tutaj jest problem, że czasami pacjenci stają się oporni na lek, a potem lata po ogłoszeniu, że są wolni od raka, wracają.	But here is the problem sometimes patients become resistant to the drug and then years after they have been declared to be cancer free they come back.	Jest jednak problem pacjenci czasami stają się odporni na lek i 10 lat po wyleczeniu raka wracają do nas.
Nie, to powinien być gadżet Go Go.	No It should be Go Go Gadget.	Nie Inspektora Gadżeta! .
To rozmowa o potencjale.	It is a conversation about potential.	O możliwościach.
Susan Boyle.	Susan Boyle.	Susan Boyle.
Chodzi mi o to, że jeśli wymagałoby to tysięcy lat, byłoby to bezwartościowe z punktu widzenia kontroli tych patogenów.	I mean if this would require thousands of years then it is worthless in terms of controlling of these pathogens.	Bo jeśli zajmuje to tysiąclecia to jest to dla nas nieprzydatne.
Co ciekawe, w ciągu ostatnich 10 lat Norman Foster wraz z inżynierem konstrukcyjnym Chrisem Williamsem użył podobnego modelu wymiany ciepła do wygenerowania dachu Galerii Narodowej.	Interestingly in the last 10 years Norman Foster used a similar heat thermal transfer model to generate the roof of the National Gallery with the structural engineer Chris Williams.	Tylko w ostatnich dziesięciu latach Norman Foster używał podobnego modelu termodynamicznego do wygenerowania zadaszenia National Gallery razem z inżynierem od konstrukcji Chris em Williams em.
Więc to, co dzieje się dzisiaj, to fakt, że istnieje model naturalnej formy, który jest oparty na rachunku różniczkowym i który wykorzystuje narzędzia cyfrowe i ma wiele implikacji dla sposobu, w jaki myślimy o pięknie i formie, a także ma wiele implikacji w sposób, w jaki myślimy o naturze.	So what is going on today is that there is a model of natural form which is calculus based and which is using digital tools and that has a lot of implications to the way we think about beauty and form and it has a lot of implications in the way we think about nature.	Dzisiaj natomiast mamy model form natury oparty na rachunku całkowym i różniczkowym i wykorzystujący cyfrowe narzędzia. To z kolei ma duży wpływ na nasze myślenie o pięknie i o formie oraz na nasze myślenie o naturze.
To jest nasza motywacja.	This is our motivation.	To jest naszą motywacją.
Nie ma procesu uczenia się.	There is not a learning process.	Nie jest to nabyta umiejętność.
Każdy rząd w tym miejscu reprezentuje jedną z tych 11 stref.	Every row across here represents one of those 11 zones.	Każdy z poprzecznych rzędów odpowiada jednej z 11 stref.
Logika jest tutaj nieco bardziej subtelna.	And the logic is a little more subtle here.	Zależność jest tutaj nieco subtelniejsza.
I naprawdę doceniamy, że jesteście tu dzisiaj wszyscy.	And we really appreciate you all being here today.	Naprawdę doceniamy że jesteście tu dziś.
Oczywiście jest to ciężkie dla Amandy.	Obviously that is heavy for Amanda.	Oczywiście jest ciężka dla Amandy.
Używamy biologicznego wzmacniacza do wzmacniania tych sygnałów nerwowych mięśni.	We are using a biological amplifier to amplify these nerve signals muscles.	Używamy biologicznego wzmacniacza działającego na sygnały nerwowe są to mięśnie.
W rzeczywistości większość z tego wydarzyła się tylko jednego dnia.	In fact most of that happened on just one day.	W rzeczywistości większość państw przystąpiła jednego dnia.
Im więcej mamy rurociągów, tym więcej będziemy mieli jedwabnych dróg i mniej dominującej konkurencji Wielkiej Gry w XXI wieku.	The more pipelines we have the more silk roads we will have and the less of a dominant Great Game competition we will have in the 21st century.	Im więcej mamy rurociągów tym więcej jedwabnych szlaków i mniej polegającej na dominacji Wielkiej Gry w XXI wieku.
Przejęli przemysł drzewny i wysyłają drewno z powrotem na wschód do Chin.	They have taken over the timber industry and been shipping the lumber east back into China.	Przejęli przemysł drzewny i transportują drewno na wschód do Chin.
Jak to mogło działać.	How could that work.	Jak to może działać?
Jeden gen jest zmieniony z 20000 i spójrz na to.	One gene is changed out of 20000 and look at it.	Zmieniony jest tylko jeden gen spośród 20 000 i spójrzcie na to.
Aby czerpać zyski ze swojej ropy, musi ją eksportować przez Turcję lub Syrię i inne kraje oraz sam Irak.	In order to profit from its oil it has to export it through Turkey or Syria and other countries and Iraq itself.	bo inaczej nie zarobi na ropie którą musi eksportować przez Turcję lub Syrię i inne kraje w tym Irak.
Mając do czynienia z mową ciała, musisz zrobić.	With body language here is what you have got to do.	Oto co trzeba robić .
Podczas gdy miasto Toronto najwyraźniej nie chce, abyś był zaangażowany w proces planowania, w przeciwnym razie ich reklamy wyglądałyby mniej więcej tak, a wszystkie informacje byłyby w zasadzie jasno przedstawione.	Whereas the city of Toronto clearly doesn not want you involved with the planning process otherwise their ads would look something like this with all the information basically laid out clearly.	Podczas gdy miasto Toronto wyraźnie nie chce abyś zaangażował się w proces planowania ponieważ gdyby chciało jego reklamy byłyby mniej więcej takie z wyeksponowanymi wszystkimi informacjami.
Myśleli, że po prostu się ubierasz i nic nie możesz z tym zrobić, tak jak stary but.	They thought you just wear out there is nothing you can do about it kind of like an old shoe.	Sądzili że się po prostu zużywamy i że nic nie można z tym zrobić coś jak stary but.
Dlaczego to robią? Ponieważ jest to tańsze, ponieważ nie pokrywają rzeczywistych kosztów środowiskowych.	Why do they do that Because it is cheaper because they don not pay the real environmental costs.	Dlaczego to robią? Bo jest taniej bo nie płacą realnych kosztów zanieczyszczenia środowiska.
Co nas czeka.	What lies ahead.	Co przyniesie przyszłość?
Choroba serca udar cukrzyca uszkodzenie rdzenia kręgowego dystrofia mięśniowa choroby siatkówki to dowolne z tych schorzeń, które dotyczą Ciebie osobiście.	Heart disease stroke diabetes spinal cord injury muscular dystrophy retinal eye diseases are any of these conditions relevant personally to you.	Chorób serca zawału cukrzycy uszkodzenia rdzenia kręgowego dystrofii mięśniowej choroby siatkówki oka czy jakieś z tych chorób dotyczą was osobiście?
Z czasem się zmieniają.	They do change over time.	Zmieniają się z biegiem czasu.
Właśnie otworzyliśmy drzwi i wszyscy powinniście przez nie przejść.	We have just opened the door and it is for all of you to step through it.	Dopiero co otworzyliśmy drzwi każdy z was jest mile widziany.
Zacznijmy więc od danych.	So let is start with the data.	Zacznijmy od danych.
Ten właściwie nigdzie nie poszedł, ale robiąc to, zmoczyłem stopy.	This one actually didn not go anywhere but I got my feet wet doing this.	Ten się nie powiódł ale wiele się przy nim nauczyłem.
Wyszli i tam, gdzie mieszka Shriram, zaszczepili dwa miliony ludzi.	They went out and where Shriram lives they vaccinated two million people.	Wyszli na ulice i tam gdzie żyją Shiraram zaszczepiono dwa miliony ludzi.
A ja lubię faceta z cygarem na dole.	And I like the guy with the cigar at the bottom there.	Podoba mi się ten na dole z cygarem.
Zawarliśmy kilka rzeczy, które, miejmy nadzieję, są przydatne.	We did include some things that are hopefully useful.	Załączyliśmy rzeczy które są przydatne.
A w Afryce Południowej szczęście kojarzy im się z seriti lub szacunkiem społeczności.	And in South Africa they associate happiness with seriti or community respect.	A w Południowej Afryce kojarzą szczęście z szacunkiem społeczności.
Więc znowu jednym z wielkich rozwiązań jest przeniesienie przez Światową Organizację Handlu dotacji na zrównoważone praktyki.	So again one of the big solutions is have the World Trade Organization shifting the subsidies to sustainable practices.	Czyli znowu warto by przeznaczyć dopłaty Światowej organizacji handlu na działania mające przyszłość.
BL Biały materiał to rodzaj bakterii, która rozwija się w temperaturze 180 stopni C.	BL The white material is a type of bacteria that thrives at 180 degrees C.	BL To białe to bakterie które żyją w temperaturze 180 stopni.
Istnieje niechęć do zadań tekstowych, która dotyczy 99 procent moich uczniów.	There is an aversion to word problems which describes 99 percent of my students.	Awersję do zadań tekstowych objawia 99% moich uczniów.
Ale poza głębokimi przywilejami federalnymi, małżonkowie zarabiają więcej pieniędzy.	But beyond the profound federal perks married people make more money.	Poza dodatkami rządowymi ludzie związni więcej zarabiają.
Tak nazywa się ikona naszego robota Jasona.	This is an icon of our robot Jason it is called.	gdzie widać naszego robota Jasona.
Dlatego naprawdę zachęcam cię, bez względu na twoją stawkę w edukacji, niezależnie od tego, czy jesteś twórcą polityki dla rodziców i nauczycieli, cokolwiek nalega na lepszy program nauczania matematyki.	So I just really encourage you whatever your stake is in education whether you are a student parent teacher policy maker whatever insist on better math curriculum.	Zachęcam wszystkich uczniów rodziców nauczycieli polityków każdego wymagajcie lepszego nauczania matematyki.
To była świetna zabawa.	This has been a lot of fun.	To mnóstwo frajdy.
Oczywiście racja.	Obvious right.	To oczywiste.
Po prawej stronie okrążamy klif.	We are coming around a cliff here on the right.	Lecimy koło klifu.
Ale w przeciwieństwie do mojego złego bliźniaka, który pożąda dominacji nad światem, moje motywy nie są złowieszcze.	But in contrast to my evil twin who lusts after world domination my motives are not sinister.	Ale w odróżnieniu od mojego złego brata bliźniaka pragnącego przejąć kontrolę nad światem nie mam zbrodniczych motywów.
Być może nadal cierpimy z powodu psychicznego bólu i rany.	Perhaps we still suffer from a psychic pain a wound.	Być może nadal cierpimy z powodu bólu i ran psychicznych.
Po prostu chciałem być w centrum.	I just wanted to be in the center.	Chciałam być w centrum wydarzeń.
Wspiera także dzieci z klasy robotniczej chodzące do indyjskich szkół.	And it also supports working class kids going into Indian schools.	To największa edukacyjna organizacja pozarządowa na świecie wspierająca też dzieci robotników chodzące do szkoły.
Współpracownik, kiedy umarł, było mi naprawdę smutno.	Collaborator I felt really sad when he died.	Współpracownik Czułem prawdziwy smutek kiedy on umarł.
Nie mieliśmy na to funduszy.	We had no funding for it.	Nie mieliśmy żadnego wsparcia finansowego.
Kiedy o tym pisałem, natknąłem się na książkę Viktora Frankla pt. Człowiek szuka sensu.	Now while I was writing about this I came upon a book called Man is Search for Meaning by Viktor Frankl.	Kiedy pisałam o tym natknęłam się na książkę Viktora Frankla „Człowiek w poszukiwaniu sensu”.
możemy cofnąć się i zmienić nasz związek, ponownie wizja naszego stosunku do ludzi z przeszłości i wydarzeń, ścieżki neuronowe mogą się zmienić.	we can go back and alter our relationship re vision our relationship to past people and events neural pathways can change.	i zmienić swoje podejście stworzyć inną wizję relacji i wydarzeń z przeszłości stworzyć inną wizję relacji i wydarzeń z przeszłości nasze drogi nerwowe mogą się zmienić.
Byłem też nazywany egipskim Libańczykiem i syryjskim Amerykaninem z perskim imieniem - kryzys pokojowy na Bliskim Wschodzie.	And I have also been called as an Egyptian Lebanese Syrian American with a Persian name the Middle East Peace Crisis.	I ze względu na to iż jestem Amerykanką o pochodzeniu egipsko libańsko syryjskim o perskim imieniu nazywali mnie Kryzysem Bliskowschodnim.
Ale ponieważ tak wiele problemów w edukacji dotyczy nie tylko szkoły, ale także rodziny i społeczności, to, czego potrzebujesz, jest zdecydowanie bardziej po prawej stronie.	But because so many of the issues in education aren not just in school they are in family and community what you also need definitely is more on the right hand side.	Kwestie edukacji dotycząca nie tylko szkół Kwestie edukacji dotycząca nie tylko szkół lecz rodzin i społeczności. Musimy więc wesprzeć rodzinę. Musimy więc wesprzeć rodzinę.
I oczywiście przyniesie to wspaniałe rzeczy.	And of course it will bring great things.	Przyniesie wielkie owoce.
I wiesz co.	And you know what.	I wiecie co?
Nazwaliśmy ten ląd Pangea.	And we called that landmass Pangea.	Nazywamy ten ląd Pangeą.
Ponieważ w przeciwnym razie może stać się dość klaustrofobiczna.	Because otherwise it can get quite claustrophobic.	bo inaczej robi się dość klaustrofobicznie.
Mógłbyś wygłosić im długie przemówienie polityczne, którego nadal by nie zrozumieli.	You could give them a long political speech they would still not understand.	Można by im wygłosić długą polityczną przemowę a oni wciąż by nie rozumieli.
W każdym razie jest to zła wiadomość dla koralowców z Wysp Galapagos.	Either case it is bad news for the corals of the Galapagos Islands.	W obu przypadkach są to złe wieści dla raf koralowych wysp Galapagos.
Trzaskujesz je razem i jeśli mamy rację, część energii tego zderzenia trafi do gruzu, który odleci do tych dodatkowych wymiarów.	You slam them together and if we are right some of the energy of that collision will go into debris that flies off into these extra dimensions.	Jeśli mamy rację część energii zderzenia Jeśli mamy rację część energii zderzenia zmieni się w coś co wyląduje w innym wymiarze.
Rozważ to Jeśli spojrzysz na instrument, waltornia zauważysz, że kształt instrumentu ma wpływ na wibracje strumieni powietrza.	Consider this If you look at the instrument a French horn notice that the vibrations of the airstreams are affected by the shape of the instrument.	W muzyce wibracje powietrza zależą od kształtu instrumentu. zależą od kształtu instrumentu.
A teraz wiemy, że w naszej niedawnej przeszłości stopił się i ponownie uformował, a poziom morza podnosił się i opadał o sześć metrów na raz.	And now we know that in our recent past it melted back and formed again and sea level went up and down six meters at a time.	A teraz wiemy że w niezbyt odległej przeszłości topniał i powstawał ponownie że poziom morza wzrastał i malał za każdym razem o 6 metrów.
A teraz pojawia się teoria strun i mówi, że tak, elektromagnetyzm mechaniki kwantowej grawitacji razem w jednym pakiecie, ale tylko wtedy, gdy wszechświat ma więcej wymiarów niż te, które widzimy.	And now string theory comes along and says yes gravity quantum mechanics electromagnetism all together in one package but only if the universe has more dimensions than the ones that we see.	W końcu teoria strun ujmuje w jedno grawitację mechanikę kwantową oddziaływanie elektromagnetyczne grawitację mechanikę kwantową oddziaływanie elektromagnetyczne Ale nie wystarczają jej wymiary które widzimy.
Przewierciliśmy sto metrów pływającego szelfu lodowego, następnie 900 metrów wody, a następnie 1300 metrów w dno morskie.	We drilled through a hundred meters of floating ice shelf then through 900 meters of water and then 1300 meters into the sea floor.	Wierciliśmy setki metrów w pływającym lodowcu szelfowym potem przez 900 metrów wody a później 1300 metrów wgłąb dna morskiego.
Więc mój proces jest bardzo prosty.	So my process is very straightforward.	Mój proces jest więc dość prosty.
Więc jedno, co możemy zrobić, to żyć dłużej.	So one thing we can do is live longer.	Możemy też żyć dłużej.
Okej, więc są fizycznie takie same.	Okay So they are physically the same.	Okej. Więc fizycznie są takie same.
Sugeruje to, że nikt nie jest zewnętrznym obserwatorem natury.	What this suggests is that no one is an outside observer of nature Okay.	To sugeruje że nikt nie jest zewnętrznym obserwatorem natury. Okej?
Tak więc w życiu i przy cięciu papieru wszystko jest ze sobą powiązane.	So in life and in papercutting everything is connected.	W życiu i wycinaniu z papieru wszystko jest powiązane.
Teraz pamiętaj, że ma iść do niebieskich kwiatów.	Now remember she is supposed to be going to the blue flowers.	Teraz pamiętajcie  że ona miała iść do niebieskich kwiatów.
Tak więc w drugiej wersji jest 100 miliardów lub 1000 miliardów ludzi na Ziemi, ale wszyscy oni są przechowywani na twardych dyskach, dyskietkach lub czymkolwiek będą mieli w przyszłości.	So in the second version of it there are 100 billion or 1000 billion people on Earth but they are all stored on hard disks or floppies or whatever they have in the future.	Więc w drugiej wersji jest 100 miliardów czy 1000 miliardów ludzi na Ziemi ale wszyscy są zarchiwizowani na dyskach dyskietkach czy co tam mają w przyszłości.
I nie zawsze ze sobą współpracują. Podoba mi się teoria Freuda, że ​​większość z nich wyklucza się nawzajem.	And they don not always work together I like Freud is theory that most of them are cancelling each other out.	które nie zawsze współpracują. Lubię teorię Freuda mówiącą że większość z nich wyklucza się nawzajem.
A jednak wciąż jest jeden na ciemnym tle, a drugi na jasnym.	And yet there is still one on a dark surround and one on a light surround.	Ale mimo wszystko jeden jest na ciemnym a drugi jasnym tle.
Nie wiem, czy nadal możesz zobaczyć czerwoną linię tutaj i na ramieniu.	I don not know if you can still see the red line here and up the arm.	Nie wiem czy nadal widać tę czerwoną linię na ręce.
